Season (Year),Team,Season or Playoff,Rank,Player,Age,Games,Games Started,Minutes Played,Field Goal,Field Goal Attempts,Field Goal %,3 Point Field Goals,3 Point Field Goals Attempts,3 Point Field Goals %,2 Point Field Goals,2 Point Field Goals Attempts,2 Point Field Goals %,Free Throws,Free Throw Attempts,Free Throw Attempts %,Offensive Rebounds,Defensive Rebounds,Total Rebounds,Assists,Steals,Blocks,Turnovers,Personal Fouls,Points
2023,Indiana Fever,Regular Season,1,Kelsey Mitchell,27,40,40,1349,245,555,0.441,102,256,0.398,143,299,0.478,136,165,0.824,13,52,65,125,37,2,92,81,728
2023,Indiana Fever,Regular Season,2,Aliyah Boston,21,40,40,1249,233,403,0.578,4,10,0.4,229,393,0.583,108,145,0.745,125,210,335,89,53,50,75,125,578
2023,Indiana Fever,Regular Season,3,Erica Wheeler,32,40,40,1071,146,367,0.398,30,97,0.309,116,270,0.43,72,82,0.878,16,104,120,201,44,3,83,96,394
2023,Indiana Fever,Regular Season,4,NaLyssa Smith,22,31,28,885,188,394,0.477,19,67,0.284,169,327,0.517,84,124,0.677,64,222,286,44,10,10,84,93,479
2023,Indiana Fever,Regular Season,5,Kristy Wallace,27,37,9,728,93,232,0.401,37,85,0.435,56,147,0.381,21,28,0.75,22,60,82,71,23,9,49,64,244
2023,Indiana Fever,Regular Season,6,Victoria Vivians,28,38,14,674,73,192,0.38,27,94,0.287,46,98,0.469,23,30,0.767,19,100,119,49,27,6,31,72,196
2023,Indiana Fever,Regular Season,7,Lexie Hull,23,30,25,619,54,145,0.372,13,60,0.217,41,85,0.482,17,22,0.773,35,47,82,32,30,9,30,84,138
2023,Indiana Fever,Regular Season,8,Grace Berger,24,36,0,524,57,127,0.449,16,34,0.471,41,93,0.441,21,25,0.84,7,49,56,67,17,6,37,38,151
2023,Indiana Fever,Regular Season,9,Emma Cannon,34,30,3,314,61,134,0.455,13,34,0.382,48,100,0.48,40,44,0.909,24,70,94,14,4,2,33,42,175
2023,Indiana Fever,Regular Season,10,Maya Caldwell,24,30,1,304,21,72,0.292,4,29,0.138,17,43,0.395,12,14,0.857,9,18,27,19,9,3,22,27,58
2023,Indiana Fever,Regular Season,11,Amanda Zahui B.,29,22,0,160,12,46,0.261,3,23,0.13,9,23,0.391,6,8,0.75,5,16,21,7,3,11,10,25,33
2023,Indiana Fever,Regular Season,12,Queen Egbo,23,16,0,143,18,45,0.4,0,0,,18,45,0.4,11,17,0.647,16,48,64,2,2,8,11,31,47
2023,Indiana Fever,Regular Season,13,Victaria Saxton,23,15,0,54,6,18,0.333,1,2,0.5,5,16,0.313,6,7,0.857,2,8,10,0,1,0,6,9,19
2023,New York Liberty,Regular Season,1,Breanna Stewart,28,40,40,1365,316,680,0.465,82,231,0.355,234,449,0.521,205,241,0.851,64,307,371,150,58,63,58,75,919
2023,New York Liberty,Regular Season,2,Betnijah Laney,29,40,40,1201,200,401,0.499,60,153,0.392,140,248,0.565,53,67,0.791,30,100,130,97,34,4,75,86,513
2023,New York Liberty,Regular Season,3,Courtney Vandersloot,34,39,39,1187,161,364,0.442,37,126,0.294,124,238,0.521,51,67,0.761,19,117,136,314,51,23,104,78,410
2023,New York Liberty,Regular Season,4,Sabrina Ionescu,25,36,36,1134,195,461,0.423,128,286,0.448,67,175,0.383,95,109,0.872,29,171,200,193,37,10,94,61,613
2023,New York Liberty,Regular Season,5,Jonquel Jones,29,40,40,1001,176,334,0.527,32,91,0.352,144,243,0.593,69,80,0.863,103,233,336,73,23,51,83,113,453
2023,New York Liberty,Regular Season,6,Kayla Thornton,30,40,0,693,65,150,0.433,25,80,0.313,40,70,0.571,23,30,0.767,48,93,141,27,28,10,20,66,178
2023,New York Liberty,Regular Season,7,Marine Johannes,28,35,5,662,89,215,0.414,56,152,0.368,33,63,0.524,15,20,0.75,8,42,50,58,23,2,47,55,249
2023,New York Liberty,Regular Season,8,Stefanie Dolson,31,23,0,273,35,68,0.515,12,26,0.462,23,42,0.548,11,14,0.786,13,32,45,27,1,6,21,41,93
2023,New York Liberty,Regular Season,9,Nyara Sabally,23,33,0,260,25,59,0.424,2,9,0.222,23,50,0.46,24,32,0.75,19,51,70,7,4,7,18,38,76
2023,New York Liberty,Regular Season,10,Jocelyn Willoughby,25,29,0,192,12,30,0.4,7,16,0.438,5,14,0.357,4,4,1,10,13,23,11,3,0,8,19,35
2023,New York Liberty,Regular Season,11,Epiphanny Prince,35,10,0,71,6,15,0.4,3,10,0.3,3,5,0.6,3,3,1,1,5,6,8,2,1,7,6,18
2023,New York Liberty,Regular Season,12,Han Xu,23,8,0,36,6,20,0.3,0,7,0,6,13,0.462,0,0,,3,4,7,0,2,1,5,2,12
2023,New York Liberty,Playoffs,1,Breanna Stewart,28,10,10,380,67,187,0.358,9,46,0.196,58,141,0.411,41,47,0.872,24,78,102,31,11,19,21,21,184
2023,New York Liberty,Playoffs,2,Betnijah Laney,29,10,10,361,61,129,0.473,19,52,0.365,42,77,0.545,11,15,0.733,12,29,41,30,8,0,20,18,152
2023,New York Liberty,Playoffs,3,Sabrina Ionescu,25,10,10,351,44,112,0.393,28,70,0.4,16,42,0.381,21,23,0.913,4,38,42,47,8,7,17,21,137
2023,New York Liberty,Playoffs,4,Jonquel Jones,29,10,10,347,62,111,0.559,9,28,0.321,53,83,0.639,37,47,0.787,40,76,116,17,7,24,20,32,170
2023,New York Liberty,Playoffs,5,Courtney Vandersloot,34,10,10,326,42,100,0.42,14,37,0.378,28,63,0.444,8,10,0.8,9,30,39,63,13,7,28,22,106
2023,New York Liberty,Playoffs,6,Marine Johannes,28,9,0,103,8,29,0.276,6,24,0.25,2,5,0.4,2,4,0.5,0,6,6,7,1,2,6,9,24
2023,New York Liberty,Playoffs,7,Kayla Thornton,30,10,0,101,12,27,0.444,6,15,0.4,6,12,0.5,2,2,1,7,8,15,3,1,2,3,11,32
2023,New York Liberty,Playoffs,8,Stefanie Dolson,31,10,0,46,6,12,0.5,1,5,0.2,5,7,0.714,0,4,0,2,3,5,1,0,1,3,4,13
2023,New York Liberty,Playoffs,9,Jocelyn Willoughby,25,3,0,7,0,2,0,0,1,0,0,1,0,2,6,0.333,1,0,1,0,1,0,0,1,2
2023,New York Liberty,Playoffs,10,Nyara Sabally,23,4,0,5,0,0,,0,0,,0,0,,0,0,,0,0,0,1,1,0,0,0,0
2023,Connecticut Sun,Regular Season,1,Alyssa Thomas,31,40,40,1446,243,513,0.474,0,3,0,243,510,0.476,133,186,0.715,80,314,394,316,73,19,137,109,619
2023,Connecticut Sun,Regular Season,2,DeWanna Bonner,35,40,40,1203,233,548,0.425,75,228,0.329,158,320,0.494,156,181,0.862,35,189,224,87,42,25,58,64,697
2023,Connecticut Sun,Regular Season,3,Tiffany Hayes,33,40,40,1082,168,353,0.476,48,131,0.366,120,222,0.541,98,126,0.778,38,82,120,105,34,3,56,114,482
2023,Connecticut Sun,Regular Season,4,Natisha Hiedeman,26,40,40,1066,123,314,0.392,59,161,0.366,64,153,0.418,34,46,0.739,8,76,84,106,35,4,57,89,339
2023,Connecticut Sun,Regular Season,5,Rebecca Allen,30,40,27,858,98,240,0.408,40,115,0.348,58,125,0.464,19,27,0.704,28,85,113,37,37,50,34,77,255
2023,Connecticut Sun,Regular Season,6,Tyasha Harris,25,40,0,668,87,209,0.416,39,84,0.464,48,125,0.384,17,25,0.68,5,29,34,68,29,3,41,43,230
2023,Connecticut Sun,Regular Season,7,Olivia Nelson-Ododa,22,39,0,585,65,121,0.537,0,0,,65,121,0.537,46,65,0.708,50,94,144,23,20,33,30,87,176
2023,Connecticut Sun,Regular Season,8,DiJonai Carrington,25,32,0,550,93,223,0.417,23,62,0.371,70,161,0.435,56,74,0.757,27,65,92,41,20,3,36,68,265
2023,Connecticut Sun,Regular Season,9,Brionna Jones,27,13,13,412,80,140,0.571,2,4,0.5,78,136,0.574,45,58,0.776,41,65,106,31,24,7,29,53,207
2023,Connecticut Sun,Regular Season,10,Leigha Brown,22,25,0,130,8,26,0.308,1,10,0.1,7,16,0.438,4,6,0.667,6,15,21,10,5,2,11,19,21
2023,Connecticut Sun,Regular Season,11,Bernadett Hatar,28,6,0,47,6,16,0.375,0,0,,6,16,0.375,0,0,,3,6,9,1,4,2,4,9,12
2023,Connecticut Sun,Regular Season,12,Liz Dixon,22,4,0,21,2,5,0.4,0,0,,2,5,0.4,0,0,,1,1,2,1,0,1,2,1,4
2023,Connecticut Sun,Regular Season,13,Kristine Anigwe,26,3,0,6,0,2,0,0,0,,0,2,0,0,0,,0,1,1,0,0,0,1,3,0
2023,Connecticut Sun,Regular Season,14,Lauren Cox,25,1,0,0,0,0,,0,0,,0,0,,0,0,,0,0,0,0,0,0,0,0,0
2023,Connecticut Sun,Playoffs,1,Alyssa Thomas,31,7,7,272,55,110,0.5,0,2,0,55,108,0.509,17,27,0.63,14,42,56,72,12,2,19,19,127
2023,Connecticut Sun,Playoffs,2,DeWanna Bonner,35,7,7,258,42,109,0.385,19,52,0.365,23,57,0.404,24,31,0.774,4,54,58,24,7,11,11,17,127
2023,Connecticut Sun,Playoffs,3,Rebecca Allen,30,6,6,185,23,47,0.489,11,26,0.423,12,21,0.571,1,1,1,9,24,33,10,9,9,6,16,58
2023,Connecticut Sun,Playoffs,4,Tiffany Hayes,33,7,7,183,39,74,0.527,15,31,0.484,24,43,0.558,7,8,0.875,9,15,24,11,4,2,7,16,100
2023,Connecticut Sun,Playoffs,5,Natisha Hiedeman,26,7,7,154,13,42,0.31,6,19,0.316,7,23,0.304,6,8,0.75,1,12,13,16,1,1,4,7,38
2023,Connecticut Sun,Playoffs,6,Tyasha Harris,25,7,0,153,24,52,0.462,13,24,0.542,11,28,0.393,4,5,0.8,1,6,7,17,5,0,7,11,65
2023,Connecticut Sun,Playoffs,7,Olivia Nelson-Ododa,22,7,1,108,14,21,0.667,0,0,,14,21,0.667,2,2,1,10,14,24,4,7,6,3,11,30
2023,Connecticut Sun,Playoffs,8,DiJonai Carrington,25,6,0,82,13,28,0.464,1,4,0.25,12,24,0.5,3,5,0.6,5,9,14,3,4,0,8,8,30
2023,Connecticut Sun,Playoffs,9,Leigha Brown,22,2,0,6,0,0,,0,0,,0,0,,0,0,,0,1,1,1,0,0,1,0,
2023,Seattle Storm,Regular Season,1,Jewell Loyd,29,38,38,1344,285,769,0.371,115,322,0.357,170,447,0.38,254,286,0.888,41,137,178,131,38,16,106,63,939
2023,Seattle Storm,Regular Season,2,Ezi Magbegor,23,40,40,1304,217,423,0.513,30,78,0.385,187,345,0.542,86,123,0.699,64,258,322,102,45,74,94,129,550
2023,Seattle Storm,Regular Season,3,Sami Whitcomb,34,40,19,978,128,320,0.4,89,231,0.385,39,89,0.438,44,53,0.83,19,95,114,115,36,14,80,74,389
2023,Seattle Storm,Regular Season,4,Jordan Horston,22,36,17,806,101,275,0.367,10,41,0.244,91,234,0.389,37,52,0.712,47,135,182,58,43,21,71,79,249
2023,Seattle Storm,Regular Season,5,Kia Nurse,27,40,20,789,80,233,0.343,50,143,0.35,30,90,0.333,24,27,0.889,12,79,91,53,24,2,29,77,234
2023,Seattle Storm,Regular Season,6,Mercedes Russell,27,37,13,705,81,157,0.516,0,1,0,81,156,0.519,23,38,0.605,39,110,149,48,16,17,55,56,185
2023,Seattle Storm,Regular Season,7,Dulcy Fankam Mendjiadeu,23,33,21,470,56,107,0.523,0,1,0,56,106,0.528,22,40,0.55,58,91,149,12,13,11,29,71,134
2023,Seattle Storm,Regular Season,8,Ivana DojkiÄ‡,25,23,15,461,48,119,0.403,23,55,0.418,25,64,0.391,31,43,0.721,4,36,40,65,18,4,35,44,150
2023,Seattle Storm,Regular Season,9,Jade Melbourne,20,29,0,307,25,64,0.391,3,20,0.15,22,44,0.5,23,29,0.793,6,28,34,35,12,1,26,46,76
2023,Seattle Storm,Regular Season,10,Joyner Holmes,25,29,2,295,33,87,0.379,13,41,0.317,20,46,0.435,13,17,0.765,19,48,67,27,9,8,15,33,92
2023,Seattle Storm,Regular Season,11,Gabby Williams,26,10,8,285,34,94,0.362,5,23,0.217,29,71,0.408,11,13,0.846,14,22,36,38,15,4,22,19,84
2023,Seattle Storm,Regular Season,12,Yvonne Turner,35,21,7,193,19,41,0.463,1,3,0.333,18,38,0.474,14,18,0.778,2,21,23,18,8,2,14,14,53
2023,Seattle Storm,Regular Season,13,Arella Guirantes,25,9,0,47,4,16,0.25,1,6,0.167,3,10,0.3,3,5,0.6,1,5,6,3,1,4,3,3,12
2023,Seattle Storm,Regular Season,14,Kaila Charles,25,4,0,41,3,12,0.25,0,2,0,3,10,0.3,0,0,,3,2,5,1,1,0,0,9,6
2023,Washington Mystics,Regular Season,1,Brittney Sykes,29,40,40,1252,229,522,0.439,56,160,0.35,173,362,0.478,122,153,0.797,38,160,198,153,84,13,96,115,636
2023,Washington Mystics,Regular Season,2,Natasha Cloud,31,37,37,1199,149,395,0.377,45,151,0.298,104,244,0.426,126,140,0.9,8,130,138,229,39,10,95,95,469
2023,Washington Mystics,Regular Season,3,Shatori Walker-Kimbrough,28,40,15,993,87,203,0.429,32,82,0.39,55,121,0.455,44,47,0.936,8,74,82,66,29,14,26,48,250
2023,Washington Mystics,Regular Season,4,Tianna Hawkins,32,40,21,923,130,265,0.491,29,87,0.333,101,178,0.567,39,52,0.75,61,138,199,56,32,14,47,99,328
2023,Washington Mystics,Regular Season,5,Ariel Atkins,26,27,27,679,104,251,0.414,42,124,0.339,62,127,0.488,61,68,0.897,18,65,83,61,32,9,35,71,311
2023,Washington Mystics,Regular Season,6,Elena Delle Donne,33,23,23,633,142,293,0.485,24,61,0.393,118,232,0.509,75,80,0.938,20,105,125,49,19,20,30,43,383
2023,Washington Mystics,Regular Season,7,Myisha Hines-Allen,27,35,18,617,73,215,0.34,18,66,0.273,55,149,0.369,33,46,0.717,37,117,154,77,23,6,52,78,197
2023,Washington Mystics,Regular Season,8,Li Meng,28,34,1,539,62,164,0.378,44,121,0.364,18,43,0.419,22,26,0.846,6,30,36,35,10,1,28,38,190
2023,Washington Mystics,Regular Season,9,Shakira Austin,22,19,17,440,77,154,0.5,0,0,,77,154,0.5,36,59,0.61,29,104,133,17,16,17,35,44,190
2023,Washington Mystics,Regular Season,10,Queen Egbo,23,21,0,332,56,103,0.544,0,0,,56,103,0.544,19,30,0.633,24,69,93,9,13,15,24,55,131
2023,Washington Mystics,Regular Season,11,Cyesha Goree,29,10,0,116,15,32,0.469,3,14,0.214,12,18,0.667,6,7,0.857,7,5,12,1,3,1,4,12,39
2023,Washington Mystics,Regular Season,12,Kristi Toliver,36,11,0,99,13,39,0.333,10,28,0.357,3,11,0.273,4,5,0.8,1,7,8,8,3,0,7,9,40
2023,Washington Mystics,Regular Season,13,Amanda Zahui B.,29,12,1,93,6,24,0.25,3,14,0.214,3,10,0.3,9,12,0.75,2,15,17,3,3,7,5,20,24
2023,Washington Mystics,Regular Season,14,Linnae Harper,28,14,0,73,8,26,0.308,4,11,0.364,4,15,0.267,0,0,,3,6,9,4,2,0,4,11,20
2023,Washington Mystics,Regular Season,15,Abby Meyers,23,9,0,36,5,13,0.385,0,4,0,5,9,0.556,3,3,1,1,3,4,0,1,2,1,5,13
2023,Washington Mystics,Playoffs,1,Brittney Sykes,29,2,2,78,12,29,0.414,2,9,0.222,10,20,0.5,4,8,0.5,3,13,16,7,4,1,6,7,30
2023,Washington Mystics,Playoffs,2,Natasha Cloud,31,2,2,74,13,30,0.433,5,10,0.5,8,20,0.4,6,6,1,0,14,14,17,4,0,3,7,37
2023,Washington Mystics,Playoffs,3,Elena Delle Donne,33,2,2,73,9,28,0.321,0,7,0,9,21,0.429,4,4,1,2,7,9,7,1,2,0,5,22
2023,Washington Mystics,Playoffs,4,Ariel Atkins,26,2,2,67,10,29,0.345,3,12,0.25,7,17,0.412,4,4,1,6,5,11,6,4,3,3,8,27
2023,Washington Mystics,Playoffs,5,Myisha Hines-Allen,27,2,2,59,14,22,0.636,1,3,0.333,13,19,0.684,2,4,0.5,5,7,12,4,0,0,3,6,31
2023,Washington Mystics,Playoffs,6,Tianna Hawkins,32,2,0,29,2,5,0.4,1,2,0.5,1,3,0.333,0,0,,4,5,9,2,0,0,2,4,5
2023,Washington Mystics,Playoffs,7,Shatori Walker-Kimbrough,28,2,0,22,2,5,0.4,0,1,0,2,4,0.5,1,2,0.5,1,2,3,1,2,3,3,3,5
2023,Washington Mystics,Playoffs,8,Li Meng,28,2,0,14,1,5,0.2,1,4,0.25,0,1,0,0,0,,0,0,0,0,1,0,1,0,3
2023,Washington Mystics,Playoffs,9,Queen Egbo,23,2,0,9,0,2,0,0,0,,0,2,0,0,0,,1,0,1,0,0,0,0,0,
2023,Dallas Wings,Regular Season,1,Arike Ogunbowale,26,40,40,1489,299,752,0.398,117,341,0.343,182,411,0.443,134,153,0.876,19,115,134,181,69,3,105,109,849
2023,Dallas Wings,Regular Season,2,Natasha Howard,31,39,39,1289,247,539,0.458,38,127,0.299,209,412,0.507,110,135,0.815,84,229,313,100,50,45,109,140,642
2023,Dallas Wings,Regular Season,3,Satou Sabally,25,38,38,1258,237,545,0.435,66,183,0.361,171,362,0.472,167,191,0.874,86,222,308,167,68,16,110,135,707
2023,Dallas Wings,Regular Season,4,Crystal Dangerfield,25,35,32,973,119,280,0.425,27,93,0.29,92,187,0.492,22,27,0.815,27,74,101,108,33,7,41,44,287
2023,Dallas Wings,Regular Season,5,Teaira McCowan,26,30,29,783,150,272,0.551,0,4,0,150,268,0.56,58,99,0.586,104,168,272,45,16,35,46,100,358
2023,Dallas Wings,Regular Season,6,Veronica Burton,22,40,13,555,25,85,0.294,13,48,0.271,12,37,0.324,31,34,0.912,22,48,70,88,29,10,17,57,94
2023,Dallas Wings,Regular Season,7,Kalani Brown,26,32,5,524,90,143,0.629,0,1,0,90,142,0.634,69,86,0.802,55,88,143,33,7,22,42,65,249
2023,Dallas Wings,Regular Season,8,Awak Kuier,21,37,4,399,36,91,0.396,2,23,0.087,34,68,0.5,21,27,0.778,23,71,94,20,7,24,22,30,95
2023,Dallas Wings,Regular Season,9,Odyssey Sims,30,28,0,335,21,69,0.304,2,15,0.133,19,54,0.352,11,20,0.55,8,29,37,62,12,0,17,31,55
2023,Dallas Wings,Regular Season,10,Maddy Siegrist,23,39,0,319,57,112,0.509,5,15,0.333,52,97,0.536,27,29,0.931,36,25,61,8,8,7,9,28,146
2023,Dallas Wings,Regular Season,11,Jasmine Dickey,23,14,0,87,13,34,0.382,0,1,0,13,33,0.394,3,6,0.5,7,4,11,1,4,1,5,15,29
2023,Dallas Wings,Regular Season,12,Ashley Joens,23,9,0,14,1,4,0.25,0,2,0,1,2,0.5,1,4,0.25,0,2,2,0,1,0,0,0,3
2023,Dallas Wings,Playoffs,1,Arike Ogunbowale,26,5,5,189,38,98,0.388,13,37,0.351,25,61,0.41,9,14,0.643,8,16,24,26,8,0,7,15,98
2023,Dallas Wings,Playoffs,2,Natasha Howard,31,5,5,171,24,66,0.364,7,20,0.35,17,46,0.37,5,6,0.833,12,30,42,11,8,7,17,13,60
2023,Dallas Wings,Playoffs,3,Satou Sabally,25,5,5,168,28,78,0.359,9,23,0.391,19,55,0.345,14,18,0.778,6,20,26,21,7,6,15,13,79
2023,Dallas Wings,Playoffs,4,Teaira McCowan,26,5,5,152,23,37,0.622,0,0,,23,37,0.622,12,23,0.522,21,42,63,8,4,7,9,14,58
2023,Dallas Wings,Playoffs,5,Odyssey Sims,30,5,2,93,13,32,0.406,3,9,0.333,10,23,0.435,3,5,0.6,2,3,5,12,4,0,5,2,32
2023,Dallas Wings,Playoffs,6,Crystal Dangerfield,25,5,3,58,8,15,0.533,2,6,0.333,6,9,0.667,5,5,1,3,4,7,5,1,0,1,4,23
2023,Dallas Wings,Playoffs,7,Veronica Burton,22,5,0,55,2,13,0.154,1,9,0.111,1,4,0.25,4,5,0.8,2,4,6,11,8,0,1,4,9
2023,Dallas Wings,Playoffs,8,Awak Kuier,21,5,0,52,9,14,0.643,2,7,0.286,7,7,1,0,2,0,2,5,7,1,3,4,4,1,20
2023,Dallas Wings,Playoffs,9,Kalani Brown,26,5,0,43,14,24,0.583,0,0,,14,24,0.583,2,5,0.4,7,4,11,2,3,1,4,5,30
2023,Dallas Wings,Playoffs,10,Maddy Siegrist,23,4,0,19,4,6,0.667,2,2,1,2,4,0.5,4,4,1,2,2,4,0,1,0,0,2,14
2023,Phoenix Mercury,Regular Season,1,Brianna Turner,26,40,33,1052,67,103,0.65,0,0,,67,103,0.65,6,12,0.5,50,203,253,50,39,44,60,89,140
2023,Phoenix Mercury,Regular Season,2,Sug Sutton,24,40,12,1051,126,328,0.384,30,90,0.333,96,238,0.403,46,57,0.807,14,88,102,190,27,3,99,62,328
2023,Phoenix Mercury,Regular Season,3,Moriah Jefferson,29,39,36,972,165,380,0.434,38,107,0.355,127,273,0.465,41,50,0.82,9,68,77,140,43,7,63,84,409
2023,Phoenix Mercury,Regular Season,4,Michaela Onyenwere,23,40,27,953,130,322,0.404,35,111,0.315,95,211,0.45,60,79,0.759,48,99,147,51,30,19,81,114,355
2023,Phoenix Mercury,Regular Season,5,Sophie Cunningham,26,31,31,898,111,269,0.413,58,172,0.337,53,97,0.546,70,80,0.875,17,71,88,65,20,11,46,99,350
2023,Phoenix Mercury,Regular Season,6,Brittney Griner,32,31,31,856,219,390,0.562,1,9,0.111,218,381,0.572,105,136,0.772,38,157,195,68,16,50,66,64,544
2023,Phoenix Mercury,Regular Season,7,Diana Taurasi,41,26,26,709,128,318,0.403,64,187,0.342,64,131,0.489,95,112,0.848,2,91,93,120,13,12,78,67,415
2023,Phoenix Mercury,Regular Season,8,Megan Gustafson,26,34,4,514,102,194,0.526,15,43,0.349,87,151,0.576,50,62,0.806,46,85,131,25,13,14,37,65,269
2023,Phoenix Mercury,Regular Season,9,Kadi Sissoko,24,40,0,336,23,62,0.371,3,18,0.167,20,44,0.455,10,16,0.625,17,45,62,8,3,5,26,43,59
2023,Phoenix Mercury,Regular Season,10,Shey Peddy,34,18,0,285,31,84,0.369,16,46,0.348,15,38,0.395,16,20,0.8,7,25,32,33,16,0,10,30,94
2023,Phoenix Mercury,Regular Season,11,Ashley Joens,23,8,0,107,12,31,0.387,10,20,0.5,2,11,0.182,2,2,1,0,9,9,1,2,0,5,7,36
2023,Phoenix Mercury,Regular Season,12,Evina Westbrook,24,9,0,72,2,20,0.1,0,11,0,2,9,0.222,6,6,1,1,8,9,4,1,1,4,7,10
2023,Phoenix Mercury,Regular Season,13,Jennie Simms,29,6,0,70,4,14,0.286,0,5,0,4,9,0.444,5,7,0.714,4,9,13,3,2,0,6,7,13
2023,Phoenix Mercury,Regular Season,14,Liz Dixon,22,10,0,56,8,14,0.571,0,0,,8,14,0.571,7,8,0.875,8,5,13,1,0,2,2,3,23
2023,Phoenix Mercury,Regular Season,15,Madi Williams,23,5,0,46,5,15,0.333,0,3,0,5,12,0.417,0,0,,2,3,5,1,2,1,6,6,10
2023,Phoenix Mercury,Regular Season,16,Destanni Henderson,24,5,0,31,2,10,0.2,1,5,0.2,1,5,0.2,2,2,1,1,3,4,2,0,0,1,4,7
2023,Phoenix Mercury,Regular Season,17,Sam Thomas,24,1,0,11,0,2,0,0,0,,0,2,0,0,0,,0,1,1,0,0,0,0,1,0
2023,Phoenix Mercury,Regular Season,18,Alaina Coates,28,2,0,5,1,1,1,0,0,,1,1,1,0,0,,0,0,0,0,1,0,0,1,2
2023,Atlanta Dream,Regular Season,1,Rhyne Howard,23,39,39,1283,226,587,0.385,99,281,0.352,127,306,0.415,130,165,0.788,26,167,193,138,51,25,75,110,681
2023,Atlanta Dream,Regular Season,2,Allisha Gray,28,38,38,1244,219,471,0.465,42,118,0.356,177,353,0.501,169,205,0.824,47,139,186,119,40,14,71,100,649
2023,Atlanta Dream,Regular Season,3,Cheyenne Parker,30,40,38,1066,232,480,0.483,15,54,0.278,217,426,0.509,121,146,0.829,87,180,267,72,43,59,91,114,600
2023,Atlanta Dream,Regular Season,4,Danielle Robinson,34,32,27,690,71,154,0.461,9,31,0.29,62,123,0.504,36,48,0.75,8,61,69,104,23,3,43,64,187
2023,Atlanta Dream,Regular Season,5,Nia Coffey,28,31,31,680,83,192,0.432,33,82,0.402,50,110,0.455,15,24,0.625,15,135,150,48,17,37,45,68,214
2023,Atlanta Dream,Regular Season,6,Monique Billings,27,39,9,653,68,167,0.407,0,4,0,68,163,0.417,51,61,0.836,53,141,194,30,16,12,37,76,187
2023,Atlanta Dream,Regular Season,7,Haley Jones,22,40,6,584,56,166,0.337,6,28,0.214,50,138,0.362,31,41,0.756,14,80,94,92,16,12,54,69,149
2023,Atlanta Dream,Regular Season,8,Aari McDonald,24,24,9,565,66,164,0.402,25,78,0.321,41,86,0.477,32,42,0.762,6,42,48,73,15,0,39,38,189
2023,Atlanta Dream,Regular Season,9,Naz Hillmon,23,40,3,541,59,116,0.509,0,1,0,59,115,0.513,46,54,0.852,50,87,137,27,8,3,39,58,164
2023,Atlanta Dream,Regular Season,10,AD Durr,26,36,0,392,62,163,0.38,19,59,0.322,43,104,0.413,30,39,0.769,3,35,38,25,10,3,28,28,173
2023,Atlanta Dream,Regular Season,11,Iliana Rupert,21,20,0,158,12,34,0.353,6,22,0.273,6,12,0.5,5,8,0.625,7,32,39,10,7,7,10,22,35
2023,Atlanta Dream,Regular Season,12,Laeticia Amihere,21,20,0,147,17,42,0.405,0,1,0,17,41,0.415,22,41,0.537,5,15,20,4,5,9,11,21,56
2023,Atlanta Dream,Regular Season,13,Taylor Mikesell,23,6,0,29,5,10,0.5,3,7,0.429,2,3,0.667,4,4,1,0,2,2,2,0,0,1,0,17
2023,Atlanta Dream,Regular Season,14,Lorela Cubaj,24,3,0,19,0,1,0,0,0,,0,1,0,0,0,,0,7,7,0,0,1,1,4,0
2023,Atlanta Dream,Playoffs,1,Rhyne Howard,23,2,2,75,22,51,0.431,11,24,0.458,11,27,0.407,2,3,0.667,1,6,7,4,4,1,4,4,57
2023,Atlanta Dream,Playoffs,2,Allisha Gray,28,2,2,72,14,33,0.424,5,13,0.385,9,20,0.45,7,10,0.7,1,13,14,8,3,1,7,4,40
2023,Atlanta Dream,Playoffs,3,Cheyenne Parker,30,2,2,67,10,31,0.323,3,6,0.5,7,25,0.28,3,4,0.75,4,9,13,4,2,4,5,6,26
2023,Atlanta Dream,Playoffs,4,Monique Billings,27,2,2,47,2,7,0.286,0,0,,2,7,0.286,5,8,0.625,5,9,14,0,1,0,3,5,9
2023,Atlanta Dream,Playoffs,5,Danielle Robinson,34,2,2,44,1,5,0.2,0,0,,1,5,0.2,3,4,0.75,2,1,3,8,2,0,4,2,5
2023,Atlanta Dream,Playoffs,6,Aari McDonald,24,2,0,36,3,11,0.273,1,4,0.25,2,7,0.286,0,0,,0,2,2,5,2,0,5,5,7
2023,Atlanta Dream,Playoffs,7,Naz Hillmon,23,2,0,28,1,1,1,0,0,,1,1,1,0,0,,1,3,4,2,1,0,2,0,2
2023,Atlanta Dream,Playoffs,8,Iliana Rupert,21,1,0,14,1,1,1,0,0,,1,1,1,0,0,,0,3,3,0,0,1,2,4,2
2023,Atlanta Dream,Playoffs,9,AD Durr,26,2,0,10,1,2,0.5,0,0,,1,2,0.5,2,2,1,0,0,0,1,0,0,0,2,4
2023,Atlanta Dream,Playoffs,10,Laeticia Amihere,21,1,0,3,0,1,0,0,0,,0,1,0,0,2,0,0,0,0,0,0,0,0,0,0
2023,Atlanta Dream,Playoffs,11,Haley Jones,22,1,0,3,1,1,1,0,0,,1,1,1,2,2,1,0,0,0,0,0,0,0,0,4
2023,Minnesota Lynx,Regular Season,1,Napheesa Collier,26,37,37,1238,297,613,0.485,34,114,0.298,263,499,0.527,168,200,0.84,70,243,313,94,61,43,89,89,796
2023,Minnesota Lynx,Regular Season,2,Kayla McBride,31,38,38,1208,187,441,0.424,83,243,0.342,104,198,0.525,85,98,0.867,14,108,122,85,47,6,65,63,542
2023,Minnesota Lynx,Regular Season,3,Dorka JuhÃ¡sz,23,38,27,919,94,199,0.472,13,48,0.271,81,151,0.536,27,50,0.54,65,182,247,99,36,23,47,70,228
2023,Minnesota Lynx,Regular Season,4,Diamond Miller,22,32,32,834,140,347,0.403,31,101,0.307,109,246,0.443,76,95,0.8,22,91,113,80,30,11,73,81,387
2023,Minnesota Lynx,Regular Season,5,Tiffany Mitchell,28,33,21,763,86,213,0.404,13,45,0.289,73,168,0.435,55,66,0.833,18,58,76,76,16,3,70,88,240
2023,Minnesota Lynx,Regular Season,6,Lindsay Allen,28,29,20,698,65,163,0.399,7,34,0.206,58,129,0.45,42,53,0.792,17,54,71,130,17,3,37,61,179
2023,Minnesota Lynx,Regular Season,7,Bridget Carleton,26,38,4,573,41,119,0.345,30,89,0.337,11,30,0.367,11,15,0.733,19,70,89,34,13,3,16,49,123
2023,Minnesota Lynx,Regular Season,8,Jessica Shepard,26,21,17,565,65,126,0.516,0,2,0,65,124,0.524,41,53,0.774,43,105,148,66,12,2,30,42,171
2023,Minnesota Lynx,Regular Season,9,Nikolina Milic,29,39,3,494,89,192,0.464,8,22,0.364,81,170,0.476,45,56,0.804,28,65,93,33,4,5,42,68,231
2023,Minnesota Lynx,Regular Season,10,Rachel Banham,29,32,1,435,61,165,0.37,43,107,0.402,18,58,0.31,11,14,0.786,4,28,32,54,11,3,36,45,176
2023,Minnesota Lynx,Regular Season,11,Aerial Powers,29,20,0,195,38,92,0.413,6,19,0.316,32,73,0.438,22,24,0.917,6,30,36,15,3,2,18,6,104
2023,Minnesota Lynx,Regular Season,12,Emily Engstler,23,12,0,93,8,21,0.381,2,7,0.286,6,14,0.429,3,8,0.375,11,18,29,7,5,1,10,8,21
2023,Minnesota Lynx,Regular Season,13,Kayana Traylor,23,8,0,35,3,10,0.3,0,1,0,3,9,0.333,2,2,1,1,0,1,3,2,0,3,5,8
2023,Minnesota Lynx,Playoffs,1,Kayla McBride,31,3,3,118,19,44,0.432,10,27,0.37,9,17,0.529,6,6,1,4,14,18,8,3,0,5,2,54
2023,Minnesota Lynx,Playoffs,2,Napheesa Collier,26,3,3,108,28,55,0.509,2,6,0.333,26,49,0.531,13,15,0.867,4,20,24,5,2,4,7,8,71
2023,Minnesota Lynx,Playoffs,3,Bridget Carleton,26,3,0,72,9,15,0.6,4,9,0.444,5,6,0.833,3,4,0.75,3,8,11,2,3,0,1,5,25
2023,Minnesota Lynx,Playoffs,4,Dorka JuhÃ¡sz,23,3,3,72,5,10,0.5,0,2,0,5,8,0.625,5,11,0.455,4,11,15,8,2,0,5,4,15
2023,Minnesota Lynx,Playoffs,5,Diamond Miller,22,3,3,69,6,23,0.261,2,9,0.222,4,14,0.286,2,3,0.667,0,4,4,6,3,0,1,11,16
2023,Minnesota Lynx,Playoffs,6,Tiffany Mitchell,28,3,3,65,5,12,0.417,1,2,0.5,4,10,0.4,0,0,,3,7,10,11,1,0,7,5,11
2023,Minnesota Lynx,Playoffs,7,Rachel Banham,29,3,0,59,6,19,0.316,3,13,0.231,3,6,0.5,0,0,,2,3,5,9,3,2,5,7,15
2023,Minnesota Lynx,Playoffs,8,Nikolina Milic,29,3,0,22,2,5,0.4,0,1,0,2,4,0.5,2,2,1,0,4,4,2,0,0,2,2,6
2023,Minnesota Lynx,Playoffs,9,Aerial Powers,29,1,0,14,0,6,0,0,2,0,0,4,0,4,4,1,1,2,3,0,1,0,3,1,4
2023,Los Angeles Sparks,Regular Season,1,Jordin Canada,27,38,38,1237,163,403,0.404,41,123,0.333,122,280,0.436,138,158,0.873,9,107,116,228,86,9,103,89,505
2023,Los Angeles Sparks,Regular Season,2,Nneka Ogwumike,32,36,36,1119,264,516,0.512,21,62,0.339,243,454,0.535,140,161,0.87,60,256,316,97,61,26,80,92,689
2023,Los Angeles Sparks,Regular Season,3,Dearica Hamby,29,40,19,990,132,306,0.431,9,41,0.22,123,265,0.464,83,128,0.648,51,185,236,71,34,12,58,86,356
2023,Los Angeles Sparks,Regular Season,4,Azura Stevens,27,35,29,910,149,369,0.404,35,109,0.321,114,260,0.438,46,61,0.754,54,153,207,40,41,32,52,90,379
2023,Los Angeles Sparks,Regular Season,5,Karlie Samuelson,28,34,23,888,82,177,0.463,49,115,0.426,33,62,0.532,48,51,0.941,11,90,101,68,22,3,30,81,261
2023,Los Angeles Sparks,Regular Season,6,Layshia Clarendon,32,24,24,687,96,193,0.497,21,46,0.457,75,147,0.51,54,59,0.915,23,50,73,82,27,0,54,63,267
2023,Los Angeles Sparks,Regular Season,7,Zia Cooke,22,39,4,549,65,225,0.289,18,69,0.261,47,156,0.301,39,48,0.813,10,27,37,31,13,12,29,36,187
2023,Los Angeles Sparks,Regular Season,8,Jasmine Thomas,33,32,7,410,30,110,0.273,15,62,0.242,15,48,0.313,10,11,0.909,10,24,34,42,9,6,21,28,85
2023,Los Angeles Sparks,Regular Season,9,Lexie Brown,28,12,11,364,54,111,0.486,27,65,0.415,27,46,0.587,14,16,0.875,2,23,25,29,11,3,16,14,149
2023,Los Angeles Sparks,Regular Season,10,Rae Burrell,23,29,3,322,36,93,0.387,16,41,0.39,20,52,0.385,17,21,0.81,13,23,36,18,13,3,15,26,105
2023,Los Angeles Sparks,Regular Season,11,Chiney Ogwumike,31,10,4,212,34,79,0.43,1,13,0.077,33,66,0.5,15,21,0.714,14,29,43,13,13,3,12,37,84
2023,Los Angeles Sparks,Regular Season,12,Destanni Henderson,24,10,1,169,17,47,0.362,2,19,0.105,15,28,0.536,14,19,0.737,2,6,8,25,7,1,13,14,50
2023,Los Angeles Sparks,Regular Season,13,Joyner Holmes,25,5,0,60,8,23,0.348,2,7,0.286,6,16,0.375,3,4,0.75,5,12,17,1,0,2,4,6,21
2023,Los Angeles Sparks,Regular Season,14,Evina Westbrook,24,9,0,56,3,10,0.3,2,5,0.4,1,5,0.2,2,2,1,2,6,8,6,2,2,6,9,10
2023,Los Angeles Sparks,Regular Season,15,Nia Clouden,23,5,1,54,3,10,0.3,1,3,0.333,2,7,0.286,1,2,0.5,0,2,2,9,0,0,8,5,8
2023,Las Vegas Aces,Regular Season,1,Chelsea Gray,30,40,40,1288,225,459,0.49,64,152,0.421,161,307,0.524,96,107,0.897,12,146,158,291,57,25,101,73,610
2023,Las Vegas Aces,Regular Season,2,Kelsey Plum,28,39,39,1265,249,524,0.475,95,244,0.389,154,280,0.55,135,148,0.912,9,86,95,177,43,0,82,94,728
2023,Las Vegas Aces,Regular Season,3,Jackie Young,25,40,40,1259,249,476,0.523,89,198,0.449,160,278,0.576,117,135,0.867,26,134,160,151,52,5,70,80,704
2023,Las Vegas Aces,Regular Season,4,A'ja Wilson,26,40,40,1228,335,601,0.557,9,29,0.31,326,572,0.57,233,287,0.812,82,298,380,64,55,89,62,85,912
2023,Las Vegas Aces,Regular Season,5,Alysha Clark,35,39,1,876,91,205,0.444,51,132,0.386,40,73,0.548,27,33,0.818,21,112,133,42,24,6,28,85,260
2023,Las Vegas Aces,Regular Season,6,Kiah Stokes,30,40,22,792,36,83,0.434,5,27,0.185,31,56,0.554,9,18,0.5,45,189,234,23,26,39,17,70,86
2023,Las Vegas Aces,Regular Season,7,Candace Parker,37,18,18,425,60,129,0.465,17,51,0.333,43,78,0.551,25,28,0.893,16,81,97,67,27,16,31,35,162
2023,Las Vegas Aces,Regular Season,8,Kierstan Bell,23,36,0,424,53,153,0.346,20,82,0.244,33,71,0.465,6,10,0.6,14,42,56,18,15,5,14,47,132
2023,Las Vegas Aces,Regular Season,9,Cayla George,34,32,0,273,30,104,0.288,15,64,0.234,15,40,0.375,0,3,0,15,43,58,13,10,5,27,36,75
2023,Las Vegas Aces,Regular Season,10,Sydney Colson,33,28,0,135,12,27,0.444,6,16,0.375,6,11,0.545,5,6,0.833,4,8,12,22,9,1,6,24,35
2023,Las Vegas Aces,Regular Season,11,Alaina Coates,28,10,0,30,4,5,0.8,0,0,,4,5,0.8,1,4,0.25,2,8,10,0,2,0,7,9,9
2023,Las Vegas Aces,Regular Season,12,Ashley Joens,23,2,0,6,0,1,0,0,1,0,0,0,,0,0,,0,0,0,0,0,0,0,0,0
2023,Las Vegas Aces,Playoffs,1,Kelsey Plum,28,9,9,331,55,132,0.417,27,67,0.403,28,65,0.431,28,32,0.875,4,25,29,34,12,0,28,22,165
2023,Las Vegas Aces,Playoffs,2,Jackie Young,25,9,9,313,48,114,0.421,22,53,0.415,26,61,0.426,32,35,0.914,3,47,50,45,14,1,11,22,150
2023,Las Vegas Aces,Playoffs,3,A'ja Wilson,26,9,9,299,82,148,0.554,1,2,0.5,81,146,0.555,49,59,0.831,28,78,106,11,13,21,19,18,214
2023,Las Vegas Aces,Playoffs,4,Chelsea Gray,30,8,8,287,48,110,0.436,11,31,0.355,37,79,0.468,18,18,1,3,35,38,54,12,8,24,12,125
2023,Las Vegas Aces,Playoffs,5,Alysha Clark,35,9,1,217,27,51,0.529,7,22,0.318,20,29,0.69,13,14,0.929,12,28,40,12,3,1,9,25,74
2023,Las Vegas Aces,Playoffs,6,Kiah Stokes,30,8,8,209,9,16,0.563,2,4,0.5,7,12,0.583,2,2,1,14,49,63,10,8,2,6,13,22
2023,Las Vegas Aces,Playoffs,7,Kierstan Bell,23,8,0,50,3,18,0.167,0,11,0,3,7,0.429,4,4,1,2,4,6,2,3,2,2,3,10
2023,Las Vegas Aces,Playoffs,8,Cayla George,34,8,1,48,4,20,0.2,3,12,0.25,1,8,0.125,2,2,1,0,5,5,4,3,0,3,5,13
2023,Las Vegas Aces,Playoffs,9,Sydney Colson,33,7,0,34,1,4,0.25,0,1,0,1,3,0.333,0,0,,1,2,3,2,1,0,3,5,2
2023,Las Vegas Aces,Playoffs,10,Alaina Coates,28,6,0,11,1,1,1,0,0,,1,1,1,0,0,,2,3,5,0,1,0,1,1,2
2023,Chicago Sky,Regular Season,1,Courtney Williams,29,40,40,1204,176,403,0.437,47,106,0.443,129,297,0.434,15,25,0.6,38,203,241,251,38,12,98,65,414
2023,Chicago Sky,Regular Season,2,Elizabeth Williams,30,40,40,1188,167,325,0.514,0,0,,167,325,0.514,58,92,0.63,90,142,232,98,50,60,54,101,392
2023,Chicago Sky,Regular Season,3,Kahleah Copper,28,38,38,1184,262,585,0.448,69,171,0.404,193,414,0.466,117,152,0.77,25,142,167,77,35,10,94,93,710
2023,Chicago Sky,Regular Season,4,Marina Mabrey,26,39,39,1169,202,491,0.411,89,228,0.39,113,263,0.43,92,110,0.836,34,112,146,140,29,18,86,93,585
2023,Chicago Sky,Regular Season,5,Alanna Smith,26,38,35,1007,132,265,0.498,30,102,0.294,102,163,0.626,55,81,0.679,70,179,249,68,49,50,56,116,349
2023,Chicago Sky,Regular Season,6,Dana Evans,24,39,1,837,116,322,0.36,42,143,0.294,74,179,0.413,76,89,0.854,7,40,47,118,27,4,61,45,350
2023,Chicago Sky,Regular Season,7,Robyn Parks,30,37,2,505,53,139,0.381,32,87,0.368,21,52,0.404,7,7,1,15,44,59,16,12,5,19,35,145
2023,Chicago Sky,Regular Season,8,Morgan Bertsch,26,28,5,398,47,103,0.456,16,36,0.444,31,67,0.463,12,16,0.75,12,35,47,19,10,7,30,50,122
2023,Chicago Sky,Regular Season,9,Sika KonÃ©,20,20,0,186,25,47,0.532,2,6,0.333,23,41,0.561,20,26,0.769,22,37,59,10,3,1,21,34,72
2023,Chicago Sky,Regular Season,10,Ruthy Hebard,25,19,0,175,31,53,0.585,0,0,,31,53,0.585,13,20,0.65,18,28,46,7,5,7,4,25,75
2023,Chicago Sky,Regular Season,11,Kristine Anigwe,26,10,0,83,10,22,0.455,0,1,0,10,21,0.476,5,8,0.625,8,13,21,4,3,5,6,20,25
2023,Chicago Sky,Regular Season,12,Rebekah Gardner,32,3,0,59,6,14,0.429,3,5,0.6,3,9,0.333,6,6,1,1,10,11,7,6,1,5,8,21
2023,Chicago Sky,Regular Season,13,Taylor Soule,23,15,0,53,2,14,0.143,0,3,0,2,11,0.182,5,8,0.625,3,5,8,3,0,1,4,6,9
2023,Chicago Sky,Regular Season,14,Khaalia Hillsman,26,1,0,1,0,0,,0,0,,0,0,,0,0,,0,0,0,0,0,0,0,0,0
2023,Chicago Sky,Playoffs,1,Kahleah Copper,28,2,2,69,13,32,0.406,5,11,0.455,8,21,0.381,9,12,0.75,4,11,15,3,1,0,6,6,40
2023,Chicago Sky,Playoffs,2,Elizabeth Williams,30,2,2,66,4,14,0.286,0,0,,4,14,0.286,0,1,0,6,14,20,6,1,4,3,3,8
2023,Chicago Sky,Playoffs,3,Marina Mabrey,26,2,2,65,8,23,0.348,2,9,0.222,6,14,0.429,1,1,1,0,7,7,3,0,3,6,7,19
2023,Chicago Sky,Playoffs,4,Courtney Williams,29,2,2,65,6,19,0.316,2,7,0.286,4,12,0.333,0,0,,2,14,16,8,1,2,7,5,14
2023,Chicago Sky,Playoffs,5,Dana Evans,24,2,0,45,10,24,0.417,2,8,0.25,8,16,0.5,7,7,1,1,0,1,7,3,0,2,3,29
2023,Chicago Sky,Playoffs,6,Alanna Smith,26,2,2,36,3,10,0.3,0,4,0,3,6,0.5,2,2,1,2,7,9,1,0,2,3,5,8
2023,Chicago Sky,Playoffs,7,Robyn Parks,30,2,0,26,2,6,0.333,1,3,0.333,1,3,0.333,0,0,,0,4,4,0,0,0,1,3,5
2023,Chicago Sky,Playoffs,8,Ruthy Hebard,25,2,0,14,1,4,0.25,0,0,,1,4,0.25,0,0,,1,1,2,0,2,1,0,2,2
2023,Chicago Sky,Playoffs,9,Sika KonÃ©,20,2,0,9,2,3,0.667,0,0,,2,3,0.667,0,0,,0,1,1,1,0,0,0,2,4
2023,Chicago Sky,Playoffs,10,Morgan Bertsch,26,1,0,5,0,2,0,0,1,0,0,1,0,0,0,,0,0,0,0,0,0,0,0,0
2023,Chicago Sky,Playoffs,11,Taylor Soule,23,1,0,1,0,0,,0,0,,0,0,,0,0,,0,0,0,0,0,0,0,0,0
2022,Chicago Sky,Regular Season,1,Emma Meesseman,29,36,36,1030,194,340,0.571,13,38,0.342,181,302,0.599,47,53,0.887,62,137,199,137,50,30,51,90,448
2022,Chicago Sky,Regular Season,2,Candace Parker,36,32,32,904,159,347,0.458,42,135,0.311,117,212,0.552,62,76,0.816,30,245,275,145,31,31,78,70,422
2022,Chicago Sky,Regular Season,3,Allie Quigley,36,34,34,895,130,304,0.428,50,141,0.355,80,163,0.491,76,80,0.95,18,68,86,97,24,7,45,50,386
2022,Chicago Sky,Regular Season,4,Kahleah Copper,27,31,31,891,176,366,0.481,36,101,0.356,140,265,0.528,100,129,0.775,32,144,176,70,14,1,63,75,488
2022,Chicago Sky,Regular Season,5,Courtney Vandersloot,33,32,32,849,136,283,0.481,29,79,0.367,107,204,0.525,75,98,0.765,23,102,125,207,38,16,87,53,376
2022,Chicago Sky,Regular Season,6,Azura Stevens,26,35,8,768,150,318,0.472,42,116,0.362,108,202,0.535,29,39,0.744,21,116,137,28,17,39,26,61,371
2022,Chicago Sky,Regular Season,7,Rebekah Gardner,31,35,2,760,116,214,0.542,15,42,0.357,101,172,0.587,48,60,0.8,44,71,115,44,49,19,55,81,295
2022,Chicago Sky,Regular Season,8,Julie Allemand,25,25,4,402,25,60,0.417,9,31,0.29,16,29,0.552,15,18,0.833,9,30,39,85,14,3,33,23,74
2022,Chicago Sky,Regular Season,9,Dana Evans,23,33,1,378,49,130,0.377,22,67,0.328,27,63,0.429,22,25,0.88,5,22,27,41,10,3,27,29,142
2022,Chicago Sky,Regular Season,10,Ruthy Hebard,24,24,0,232,25,49,0.51,0,0,,25,49,0.51,6,8,0.75,8,33,41,12,8,3,13,29,56
2022,Chicago Sky,Regular Season,11,Li Yueru,23,16,0,82,8,18,0.444,0,0,,8,18,0.444,12,12,1,5,19,24,2,2,2,13,9,28
2022,Chicago Sky,Regular Season,12,Anneli Maley,23,4,0,44,3,6,0.5,2,3,0.667,1,3,0.333,0,0,,3,4,7,3,3,1,1,6,8
2022,Chicago Sky,Regular Season,13,Sparkle Taylor,26,2,0,25,5,6,0.833,0,1,0,5,5,1,1,1,1,0,2,2,0,0,0,1,3,11
2022,Chicago Sky,Regular Season,14,Kaela Davis,27,1,0,10,0,1,0,0,0,,0,1,0,0,0,,0,1,1,1,0,0,2,3,0
2022,Chicago Sky,Regular Season,15,Tina Krajisnik,31,2,0,5,0,1,0,0,0,,0,1,0,0,0,,0,0,0,2,1,0,0,2,0
2022,Chicago Sky,Playoffs,1,Kahleah Copper,27,8,8,244,47,104,0.452,9,26,0.346,38,78,0.487,31,39,0.795,9,21,30,7,13,3,14,14,134
2022,Chicago Sky,Playoffs,2,Emma Meesseman,29,8,8,237,39,83,0.47,6,20,0.3,33,63,0.524,5,6,0.833,13,19,32,28,12,7,9,16,89
2022,Chicago Sky,Playoffs,3,Candace Parker,36,8,8,235,42,96,0.438,12,36,0.333,30,60,0.5,22,29,0.759,10,76,86,37,11,21,17,18,118
2022,Chicago Sky,Playoffs,4,Allie Quigley,36,8,8,232,26,77,0.338,15,47,0.319,11,30,0.367,10,14,0.714,1,24,25,25,8,2,10,15,77
2022,Chicago Sky,Playoffs,5,Courtney Vandersloot,33,8,8,226,39,81,0.481,6,23,0.261,33,58,0.569,8,10,0.8,1,30,31,45,9,4,17,14,92
2022,Chicago Sky,Playoffs,6,Azura Stevens,26,8,0,150,25,53,0.472,3,16,0.188,22,37,0.595,6,9,0.667,6,24,30,4,8,7,6,19,59
2022,Chicago Sky,Playoffs,7,Rebekah Gardner,31,8,0,143,14,36,0.389,0,6,0,14,30,0.467,12,14,0.857,11,15,26,14,6,3,7,14,40
2022,Chicago Sky,Playoffs,8,Julie Allemand,25,8,0,92,7,14,0.5,3,10,0.3,4,4,1,3,6,0.5,0,4,4,16,2,1,4,4,20
2022,Chicago Sky,Playoffs,9,Dana Evans,23,4,0,23,6,10,0.6,3,5,0.6,3,5,0.6,2,2,1,0,3,3,2,2,0,1,2,17
2022,Chicago Sky,Playoffs,10,Ruthy Hebard,24,4,0,17,1,5,0.2,0,1,0,1,4,0.25,0,0,,0,5,5,1,2,0,1,1,2
2022,Las Vegas Aces,Regular Season,1,Kelsey Plum,27,36,36,1182,244,531,0.46,113,269,0.42,131,262,0.5,125,149,0.839,9,87,96,184,36,2,94,90,726
2022,Las Vegas Aces,Regular Season,2,Jackie Young,24,34,34,1129,191,401,0.476,50,116,0.431,141,285,0.495,110,128,0.859,43,105,148,132,48,8,43,81,542
2022,Las Vegas Aces,Regular Season,3,A'ja Wilson,25,36,36,1080,260,519,0.501,31,83,0.373,229,436,0.525,152,187,0.813,66,273,339,75,52,70,61,76,703
2022,Las Vegas Aces,Regular Season,4,Chelsea Gray,29,35,35,1039,183,373,0.491,34,100,0.34,149,273,0.546,81,89,0.91,10,102,112,212,57,10,80,54,481
2022,Las Vegas Aces,Regular Season,5,Dearica Hamby,28,34,32,901,116,249,0.466,16,73,0.219,100,176,0.568,67,93,0.72,48,193,241,38,36,5,50,68,315
2022,Las Vegas Aces,Regular Season,6,Kiah Stokes,29,31,4,475,26,61,0.426,5,24,0.208,21,37,0.568,13,16,0.813,29,107,136,20,14,25,18,39,70
2022,Las Vegas Aces,Regular Season,7,Theresa Plaisance,30,31,2,401,43,116,0.371,31,89,0.348,12,27,0.444,7,10,0.7,16,64,80,15,8,13,20,41,124
2022,Las Vegas Aces,Regular Season,8,Riquna Williams,32,21,0,377,45,118,0.381,34,93,0.366,11,25,0.44,16,21,0.762,5,37,42,25,9,3,6,35,140
2022,Las Vegas Aces,Regular Season,9,Iliana Rupert,20,17,0,223,25,54,0.463,14,38,0.368,11,16,0.688,1,3,0.333,11,28,39,15,7,0,9,35,65
2022,Las Vegas Aces,Regular Season,10,Aisha Sheppard,23,23,0,174,10,42,0.238,9,33,0.273,1,9,0.111,6,8,0.75,6,8,14,7,5,1,7,26,35
2022,Las Vegas Aces,Regular Season,11,Sydney Colson,32,18,0,123,10,32,0.313,3,11,0.273,7,21,0.333,5,5,1,3,5,8,18,2,0,7,14,28
2022,Las Vegas Aces,Regular Season,12,Kierstan Bell,22,21,1,121,10,33,0.303,3,22,0.136,7,11,0.636,4,4,1,4,15,19,7,2,3,5,10,27
2022,Las Vegas Aces,Playoffs,1,A'ja Wilson,25,10,10,372,74,134,0.552,2,14,0.143,72,120,0.6,53,67,0.791,15,89,104,20,10,24,13,21,203
2022,Las Vegas Aces,Playoffs,2,Jackie Young,24,10,10,345,41,95,0.432,18,38,0.474,23,57,0.404,25,27,0.926,2,39,41,30,8,1,16,29,125
2022,Las Vegas Aces,Playoffs,3,Chelsea Gray,29,10,10,340,88,144,0.611,31,57,0.544,57,87,0.655,10,12,0.833,0,38,38,70,12,6,30,19,217
2022,Las Vegas Aces,Playoffs,4,Kelsey Plum,27,10,10,333,56,137,0.409,18,63,0.286,38,74,0.514,41,46,0.891,8,31,39,38,9,0,19,22,171
2022,Las Vegas Aces,Playoffs,5,Kiah Stokes,29,10,10,259,17,35,0.486,1,5,0.2,16,30,0.533,2,2,1,16,56,72,4,6,8,8,26,37
2022,Las Vegas Aces,Playoffs,6,Riquna Williams,32,10,0,203,24,69,0.348,19,53,0.358,5,16,0.313,2,2,1,4,23,27,10,8,2,4,9,69
2022,Las Vegas Aces,Playoffs,7,Dearica Hamby,28,6,0,51,3,5,0.6,0,1,0,3,4,0.75,1,4,0.25,2,7,9,5,1,1,4,6,7
2022,Las Vegas Aces,Playoffs,8,Iliana Rupert,20,7,0,49,5,16,0.313,5,14,0.357,0,2,0,0,0,,1,2,3,0,0,1,3,6,15
2022,Las Vegas Aces,Playoffs,9,Theresa Plaisance,30,4,0,20,2,5,0.4,1,3,0.333,1,2,0.5,0,0,,0,5,5,2,1,2,1,4,5
2022,Las Vegas Aces,Playoffs,10,Kierstan Bell,22,4,0,19,4,6,0.667,3,5,0.6,1,1,1,0,1,0,0,5,5,1,0,0,2,2,11
2022,Las Vegas Aces,Playoffs,11,Sydney Colson,32,4,0,19,0,4,0,0,1,0,0,3,0,0,0,,1,3,4,4,0,0,1,2,0
2022,Las Vegas Aces,Playoffs,12,Aisha Sheppard,23,4,0,16,0,4,0,0,3,0,0,1,0,0,0,,0,0,0,3,0,0,2,1,0
2022,Connecticut Sun,Regular Season,1,Alyssa Thomas,30,36,36,1154,188,376,0.5,0,2,0,188,374,0.503,108,148,0.73,74,220,294,218,62,7,103,101,484
2022,Connecticut Sun,Regular Season,2,DeWanna Bonner,34,33,33,991,156,355,0.439,46,140,0.329,110,215,0.512,86,104,0.827,25,131,156,91,41,11,52,59,444
2022,Connecticut Sun,Regular Season,3,Courtney Williams,28,34,34,950,165,387,0.426,22,65,0.338,143,322,0.444,27,36,0.75,30,126,156,111,33,14,57,54,379
2022,Connecticut Sun,Regular Season,4,Brionna Jones,26,36,7,905,186,326,0.571,0,6,0,186,320,0.581,124,147,0.844,95,90,185,45,44,13,54,94,496
2022,Connecticut Sun,Regular Season,5,Natisha Hiedeman,25,36,31,901,118,274,0.431,69,168,0.411,49,106,0.462,24,30,0.8,6,57,63,118,42,4,47,66,329
2022,Connecticut Sun,Regular Season,6,Jonquel Jones,28,33,32,871,176,343,0.513,41,111,0.369,135,232,0.582,89,111,0.802,85,198,283,59,35,38,85,89,482
2022,Connecticut Sun,Regular Season,7,DiJonai Carrington,24,36,2,631,84,203,0.414,19,62,0.306,65,141,0.461,57,76,0.75,38,73,111,38,30,3,59,70,244
2022,Connecticut Sun,Regular Season,8,Nia Clouden,22,28,0,250,18,53,0.34,12,29,0.414,6,24,0.25,10,17,0.588,2,21,23,21,6,1,12,26,58
2022,Connecticut Sun,Regular Season,9,Joyner Holmes,24,26,0,205,19,61,0.311,5,22,0.227,14,39,0.359,10,13,0.769,6,29,35,12,8,2,19,20,53
2022,Connecticut Sun,Regular Season,10,Jasmine Thomas,32,5,5,109,8,30,0.267,5,13,0.385,3,17,0.176,12,13,0.923,2,9,11,15,3,1,7,7,33
2022,Connecticut Sun,Regular Season,11,Yvonne Anderson,32,11,0,101,12,26,0.462,4,10,0.4,8,16,0.5,7,7,1,3,6,9,12,3,2,11,14,35
2022,Connecticut Sun,Regular Season,12,Odyssey Sims,29,5,0,91,10,30,0.333,3,11,0.273,7,19,0.368,6,6,1,1,5,6,13,7,0,7,7,29
2022,Connecticut Sun,Regular Season,13,Jazmine Jones,25,7,0,44,2,7,0.286,0,2,0,2,5,0.4,2,5,0.4,0,1,1,1,2,0,3,5,6
2022,Connecticut Sun,Regular Season,14,Bria Hartley,29,3,0,36,5,11,0.455,4,8,0.5,1,3,0.333,0,0,,0,2,2,4,3,0,1,2,14
2022,Connecticut Sun,Regular Season,15,Stephanie Jones,23,2,0,8,0,1,0,0,0,,0,1,0,2,2,1,0,0,0,1,0,0,0,1,2
2022,Connecticut Sun,Regular Season,16,Kiana Williams,23,1,0,3,0,0,,0,0,,0,0,,0,0,,0,0,0,0,0,0,0,0,0
2022,Connecticut Sun,Playoffs,1,Alyssa Thomas,30,12,12,402,64,135,0.474,0,1,0,64,134,0.478,19,33,0.576,28,86,114,75,18,8,30,29,147
2022,Connecticut Sun,Playoffs,2,DeWanna Bonner,34,12,12,378,46,135,0.341,15,51,0.294,31,84,0.369,39,44,0.886,14,55,69,43,18,8,20,17,146
2022,Connecticut Sun,Playoffs,3,Courtney Williams,28,12,12,325,56,135,0.415,7,22,0.318,49,113,0.434,4,6,0.667,11,36,47,28,7,6,17,26,123
2022,Connecticut Sun,Playoffs,4,Jonquel Jones,28,12,12,324,69,136,0.507,12,29,0.414,57,107,0.533,29,35,0.829,34,67,101,24,7,13,25,31,179
2022,Connecticut Sun,Playoffs,5,Natisha Hiedeman,25,12,12,314,36,86,0.419,16,36,0.444,20,50,0.4,10,13,0.769,6,19,25,36,8,3,12,21,98
2022,Connecticut Sun,Playoffs,6,Brionna Jones,26,12,0,255,48,92,0.522,0,2,0,48,90,0.533,27,38,0.711,21,27,48,16,11,3,14,33,123
2022,Connecticut Sun,Playoffs,7,DiJonai Carrington,24,12,0,175,27,60,0.45,3,13,0.231,24,47,0.511,14,20,0.7,2,30,32,9,12,2,15,16,71
2022,Connecticut Sun,Playoffs,8,Odyssey Sims,29,12,0,165,17,39,0.436,2,7,0.286,15,32,0.469,7,8,0.875,0,18,18,15,5,0,10,13,43
2022,Connecticut Sun,Playoffs,9,Nia Clouden,22,7,0,32,4,9,0.444,1,2,0.5,3,7,0.429,4,4,1,0,2,2,5,2,0,1,4,13
2022,Connecticut Sun,Playoffs,10,Joyner Holmes,24,7,0,29,2,4,0.5,0,1,0,2,3,0.667,2,2,1,1,8,9,5,1,0,1,0,6
2022,Seattle Storm,Regular Season,1,Jewell Loyd,28,36,36,1090,201,508,0.396,84,218,0.385,117,290,0.403,100,112,0.893,20,75,95,121,39,7,78,64,586
2022,Seattle Storm,Regular Season,2,Breanna Stewart,27,34,34,1052,255,540,0.472,67,177,0.379,188,363,0.518,164,196,0.837,46,211,257,97,54,31,43,72,741
2022,Seattle Storm,Regular Season,3,Gabby Williams,25,36,36,920,108,243,0.444,18,70,0.257,90,173,0.52,35,45,0.778,43,136,179,111,53,14,52,59,269
2022,Seattle Storm,Regular Season,4,Sue Bird,41,31,31,818,85,211,0.403,56,144,0.389,29,67,0.433,16,16,1,6,53,59,186,38,4,60,23,242
2022,Seattle Storm,Regular Season,5,Ezi Magbegor,22,33,23,817,133,242,0.55,10,29,0.345,123,213,0.577,39,53,0.736,53,131,184,45,29,58,45,95,315
2022,Seattle Storm,Regular Season,6,Briann January,35,36,5,608,46,122,0.377,23,74,0.311,23,48,0.479,19,23,0.826,7,29,36,85,23,8,53,59,134
2022,Seattle Storm,Regular Season,7,Stephanie Talbot,28,34,1,548,64,138,0.464,29,73,0.397,35,65,0.538,14,24,0.583,23,84,107,45,24,11,36,44,171
2022,Seattle Storm,Regular Season,8,Tina Charles,33,18,10,453,94,197,0.477,15,44,0.341,79,153,0.516,23,26,0.885,36,97,133,33,11,11,34,53,226
2022,Seattle Storm,Regular Season,9,Epiphanny Prince,34,33,0,406,44,124,0.355,21,59,0.356,23,65,0.354,21,25,0.84,6,26,32,58,20,3,15,30,130
2022,Seattle Storm,Regular Season,10,Jantel Lavender,33,27,4,329,45,110,0.409,5,24,0.208,40,86,0.465,8,12,0.667,26,63,89,24,3,4,24,30,103
2022,Seattle Storm,Regular Season,11,Reshanda Gray,29,11,0,85,10,20,0.5,2,3,0.667,8,17,0.471,5,6,0.833,11,13,24,1,2,0,9,19,27
2022,Seattle Storm,Regular Season,12,Mercedes Russell,26,5,0,54,4,8,0.5,0,0,,4,8,0.5,2,3,0.667,2,7,9,1,0,0,7,7,10
2022,Seattle Storm,Regular Season,13,Kiana Williams,23,3,0,27,2,8,0.25,1,4,0.25,1,4,0.25,0,0,,0,2,2,5,0,0,2,1,5
2022,Seattle Storm,Regular Season,14,Kaela Davis,27,1,0,18,4,7,0.571,2,3,0.667,2,4,0.5,1,1,1,1,1,2,0,2,0,1,4,11
2022,Seattle Storm,Regular Season,15,Raina Perez,23,1,0,2,0,0,,0,0,,0,0,,0,0,,0,0,0,1,0,0,0,0,0
2022,Seattle Storm,Playoffs,1,Breanna Stewart,27,6,6,233,58,113,0.513,13,25,0.52,45,88,0.511,33,37,0.892,8,49,57,25,6,11,12,15,162
2022,Seattle Storm,Playoffs,2,Jewell Loyd,28,6,6,222,37,95,0.389,15,42,0.357,22,53,0.415,26,28,0.929,2,12,14,15,3,0,6,16,115
2022,Seattle Storm,Playoffs,3,Sue Bird,41,6,6,214,22,51,0.431,13,30,0.433,9,21,0.429,4,4,1,1,12,13,46,5,1,6,6,61
2022,Seattle Storm,Playoffs,4,Tina Charles,33,6,6,157,31,72,0.431,3,13,0.231,28,59,0.475,4,14,0.286,16,37,53,11,3,3,8,12,69
2022,Seattle Storm,Playoffs,5,Stephanie Talbot,28,6,2,128,13,29,0.448,8,16,0.5,5,13,0.385,3,5,0.6,4,22,26,10,3,3,6,17,37
2022,Seattle Storm,Playoffs,6,Gabby Williams,25,4,4,101,16,24,0.667,2,6,0.333,14,18,0.778,6,7,0.857,6,10,16,11,6,1,6,8,40
2022,Seattle Storm,Playoffs,7,Ezi Magbegor,22,6,0,93,14,24,0.583,0,0,,14,24,0.583,2,3,0.667,3,13,16,6,4,6,1,12,30
2022,Seattle Storm,Playoffs,8,Briann January,35,6,0,43,3,6,0.5,0,3,0,3,3,1,0,0,,0,3,3,7,0,0,4,2,6
2022,Seattle Storm,Playoffs,9,Epiphanny Prince,34,6,0,34,1,5,0.2,0,3,0,1,2,0.5,0,0,,0,2,2,2,1,0,1,3,2
2022,Washington Mystics,Regular Season,1,Ariel Atkins,25,36,36,1081,185,440,0.42,70,192,0.365,115,248,0.464,87,103,0.845,34,83,117,83,49,9,51,99,527
2022,Washington Mystics,Regular Season,2,Natasha Cloud,30,34,34,1065,123,308,0.399,43,135,0.319,80,173,0.462,75,91,0.824,16,106,122,239,34,10,94,55,364
2022,Washington Mystics,Regular Season,3,Shakira Austin,21,36,32,776,122,223,0.547,0,1,0,122,222,0.55,68,109,0.624,63,170,233,33,26,30,54,84,312
2022,Washington Mystics,Regular Season,4,Alysha Clark,34,29,29,766,91,196,0.464,30,99,0.303,61,97,0.629,21,23,0.913,23,108,131,59,27,8,38,55,233
2022,Washington Mystics,Regular Season,5,Shatori Walker-Kimbrough,27,35,3,705,80,199,0.402,26,75,0.347,54,124,0.435,55,61,0.902,10,54,64,53,37,10,39,43,241
2022,Washington Mystics,Regular Season,6,Elena Delle Donne,32,25,25,694,155,323,0.48,35,95,0.368,120,228,0.526,84,92,0.913,30,128,158,57,12,27,27,36,429
2022,Washington Mystics,Regular Season,7,Myisha Hines-Allen,26,34,15,656,114,275,0.415,29,79,0.367,85,196,0.434,45,64,0.703,37,142,179,66,26,10,58,56,302
2022,Washington Mystics,Regular Season,8,Rui Machida,29,36,2,463,26,84,0.31,7,34,0.206,19,50,0.38,6,9,0.667,6,34,40,93,16,2,38,25,65
2022,Washington Mystics,Regular Season,9,Elizabeth Williams,29,30,0,447,68,141,0.482,0,0,,68,141,0.482,25,43,0.581,45,70,115,14,18,20,19,44,161
2022,Washington Mystics,Regular Season,10,Tianna Hawkins,31,25,0,320,44,114,0.386,14,53,0.264,30,61,0.492,20,21,0.952,15,44,59,20,9,2,30,43,122
2022,Washington Mystics,Regular Season,11,Kennedy Burke,25,16,4,222,33,74,0.446,11,32,0.344,22,42,0.524,10,17,0.588,8,27,35,7,16,4,8,17,87
2022,Washington Mystics,Regular Season,12,Evina Westbrook,23,6,0,32,6,9,0.667,3,6,0.5,3,3,1,5,6,0.833,0,0,0,3,2,1,3,4,20
2022,Washington Mystics,Regular Season,13,Katie Benzan,24,3,0,27,5,9,0.556,5,7,0.714,0,2,0,3,4,0.75,1,1,2,1,0,1,2,7,18
2022,Washington Mystics,Regular Season,14,Stephanie Jones,23,3,0,19,3,7,0.429,1,2,0.5,2,5,0.4,0,0,,1,1,2,1,1,0,0,4,7
2022,Washington Mystics,Regular Season,15,Jazmine Jones,25,1,0,3,0,1,0,0,1,0,0,0,,0,0,,0,1,1,0,0,0,0,0,0
2022,Washington Mystics,Playoffs,1,Natasha Cloud,30,2,2,71,13,26,0.5,7,10,0.7,6,16,0.375,4,4,1,0,12,12,6,1,3,6,3,37
2022,Washington Mystics,Playoffs,2,Ariel Atkins,25,2,2,66,11,29,0.379,7,14,0.5,4,15,0.267,2,2,1,2,1,3,11,1,0,2,8,31
2022,Washington Mystics,Playoffs,3,Elena Delle Donne,32,2,2,66,16,31,0.516,1,9,0.111,15,22,0.682,5,5,1,2,3,5,10,1,2,3,5,38
2022,Washington Mystics,Playoffs,4,Shakira Austin,21,2,2,54,6,13,0.462,0,0,,6,13,0.462,2,4,0.5,6,9,15,2,2,1,5,3,14
2022,Washington Mystics,Playoffs,5,Alysha Clark,34,2,2,51,4,7,0.571,2,4,0.5,2,3,0.667,2,3,0.667,0,7,7,6,3,1,1,5,12
2022,Washington Mystics,Playoffs,6,Shatori Walker-Kimbrough,27,2,0,41,5,9,0.556,3,6,0.5,2,3,0.667,2,2,1,0,0,0,1,3,0,1,2,15
2022,Washington Mystics,Playoffs,7,Myisha Hines-Allen,26,2,0,29,2,11,0.182,0,1,0,2,10,0.2,6,6,1,2,5,7,4,2,0,2,1,10
2022,Washington Mystics,Playoffs,8,Rui Machida,29,2,0,11,2,3,0.667,1,2,0.5,1,1,1,0,0,,1,0,1,1,0,0,0,1,5
2022,Washington Mystics,Playoffs,9,Elizabeth Williams,29,2,0,11,2,2,1,0,0,,2,2,1,1,4,0.25,0,2,2,0,0,1,0,0,5
2022,Dallas Wings,Regular Season,1,Allisha Gray,27,33,33,1086,146,345,0.423,64,157,0.408,82,188,0.436,83,104,0.798,29,130,159,84,37,24,42,78,439
2022,Dallas Wings,Regular Season,2,Kayla Thornton,29,36,35,1050,97,206,0.471,25,76,0.329,72,130,0.554,68,82,0.829,65,146,211,65,39,20,42,97,287
2022,Dallas Wings,Regular Season,3,Marina Mabrey,25,34,32,951,178,424,0.42,61,174,0.351,117,250,0.468,47,69,0.681,20,104,124,125,28,13,83,86,464
2022,Dallas Wings,Regular Season,4,Arike Ogunbowale,25,30,30,941,204,510,0.4,83,236,0.352,121,274,0.442,99,124,0.798,18,80,98,108,45,3,54,65,590
2022,Dallas Wings,Regular Season,5,Isabelle Harrison,28,35,18,644,116,249,0.466,2,2,1,114,247,0.462,72,83,0.867,48,102,150,46,26,5,46,73,306
2022,Dallas Wings,Regular Season,6,Teaira McCowan,25,33,15,623,139,231,0.602,0,0,,139,231,0.602,84,140,0.6,98,134,232,25,11,22,56,102,362
2022,Dallas Wings,Regular Season,7,Tyasha Harris,24,35,5,552,69,166,0.416,17,55,0.309,52,111,0.468,19,24,0.792,6,26,32,99,13,4,39,35,174
2022,Dallas Wings,Regular Season,8,Veronica Burton,21,36,6,548,25,76,0.329,12,43,0.279,13,33,0.394,32,32,1,18,36,54,68,34,11,35,51,94
2022,Dallas Wings,Regular Season,9,Awak Kuier,20,33,0,416,34,86,0.395,4,21,0.19,30,65,0.462,19,31,0.613,23,59,82,29,13,29,19,26,91
2022,Dallas Wings,Regular Season,10,Satou Sabally,24,11,6,239,41,103,0.398,10,43,0.233,31,60,0.517,32,35,0.914,9,44,53,23,5,2,25,35,124
2022,Dallas Wings,Regular Season,11,Jasmine Dickey,22,20,0,93,7,33,0.212,1,4,0.25,6,29,0.207,6,9,0.667,6,6,12,2,4,1,5,9,21
2022,Dallas Wings,Regular Season,12,Charli Collier,22,17,0,78,12,27,0.444,0,2,0,12,25,0.48,10,14,0.714,4,6,10,2,1,0,10,19,34
2022,Dallas Wings,Regular Season,13,Moriah Jefferson,28,1,0,4,0,0,,0,0,,0,0,,0,0,,0,0,0,0,0,0,0,0,0
2022,Dallas Wings,Playoffs,1,Allisha Gray,27,3,3,107,15,31,0.484,3,13,0.231,12,18,0.667,6,10,0.6,3,8,11,14,5,1,2,6,39
2022,Dallas Wings,Playoffs,2,Marina Mabrey,25,3,3,98,18,42,0.429,5,11,0.455,13,31,0.419,4,4,1,2,10,12,5,2,2,14,10,45
2022,Dallas Wings,Playoffs,3,Veronica Burton,21,3,3,84,6,15,0.4,3,10,0.3,3,5,0.6,4,5,0.8,4,4,8,10,6,1,6,5,19
2022,Dallas Wings,Playoffs,4,Kayla Thornton,29,3,3,79,10,19,0.526,4,8,0.5,6,11,0.545,1,1,1,3,11,14,4,1,2,3,11,25
2022,Dallas Wings,Playoffs,5,Teaira McCowan,25,3,1,74,12,25,0.48,0,0,,12,25,0.48,8,15,0.533,11,17,28,3,1,5,10,9,32
2022,Dallas Wings,Playoffs,6,Tyasha Harris,24,3,0,52,7,19,0.368,2,7,0.286,5,12,0.417,2,2,1,3,4,7,7,1,1,4,3,18
2022,Dallas Wings,Playoffs,7,Satou Sabally,24,3,0,46,7,21,0.333,3,10,0.3,4,11,0.364,4,5,0.8,0,4,4,9,0,1,2,6,21
2022,Dallas Wings,Playoffs,8,Isabelle Harrison,28,3,2,37,7,13,0.538,0,0,,7,13,0.538,2,2,1,1,4,5,1,1,0,1,3,16
2022,Dallas Wings,Playoffs,9,Awak Kuier,20,3,0,15,0,3,0,0,2,0,0,1,0,0,0,,1,4,5,0,0,2,0,0,0
2022,Dallas Wings,Playoffs,10,Arike Ogunbowale,25,1,0,6,0,3,0,0,2,0,0,1,0,0,0,,0,0,0,0,0,0,0,0,0
2022,Dallas Wings,Playoffs,11,Jasmine Dickey,22,1,0,2,0,2,0,0,0,,0,2,0,0,0,,0,0,0,0,0,0,0,0,0
2022,New York Liberty,Regular Season,1,Sabrina Ionescu,24,36,36,1163,211,513,0.411,83,249,0.333,128,264,0.485,121,130,0.931,35,219,254,228,39,10,109,76,626
2022,New York Liberty,Regular Season,2,Natasha Howard,30,35,35,1048,206,427,0.482,30,92,0.326,176,335,0.525,88,123,0.715,69,187,256,81,45,35,113,110,530
2022,New York Liberty,Regular Season,3,Stefanie Dolson,30,36,36,826,113,229,0.493,26,66,0.394,87,163,0.534,38,42,0.905,43,129,172,66,14,28,56,112,290
2022,New York Liberty,Regular Season,4,Sami Whitcomb,33,35,6,746,74,202,0.366,59,168,0.351,15,34,0.441,20,23,0.87,11,72,83,82,23,5,49,57,227
2022,New York Liberty,Regular Season,5,Crystal Dangerfield,24,30,27,662,60,152,0.395,21,65,0.323,39,87,0.448,21,30,0.7,13,50,63,75,18,2,28,42,162
2022,New York Liberty,Regular Season,6,Marine Johannes,27,24,10,612,83,179,0.464,55,126,0.437,28,53,0.528,20,23,0.87,5,35,40,82,14,3,44,38,241
2022,New York Liberty,Regular Season,7,Han Xu,22,32,0,538,109,221,0.493,16,36,0.444,93,185,0.503,39,49,0.796,38,77,115,30,17,21,23,31,273
2022,New York Liberty,Regular Season,8,Rebecca Allen,29,25,19,523,64,169,0.379,26,83,0.313,38,86,0.442,20,24,0.833,8,76,84,31,21,24,24,48,174
2022,New York Liberty,Regular Season,9,Michaela Onyenwere,22,34,1,466,49,130,0.377,15,50,0.3,34,80,0.425,46,55,0.836,13,57,70,13,14,8,25,69,159
2022,New York Liberty,Regular Season,10,Betnijah Laney,28,9,6,255,38,90,0.422,11,29,0.379,27,61,0.443,14,16,0.875,1,29,30,25,4,1,24,24,101
2022,New York Liberty,Regular Season,11,DiDi Richards,23,14,0,155,11,36,0.306,3,11,0.273,8,25,0.32,7,10,0.7,5,19,24,20,1,5,13,25,32
2022,New York Liberty,Regular Season,12,Jocelyn Willoughby,24,11,4,121,11,26,0.423,3,11,0.273,8,15,0.533,4,8,0.5,2,16,18,4,5,2,9,8,29
2022,New York Liberty,Regular Season,13,Lorela Cubaj,23,11,0,88,4,12,0.333,0,0,,4,12,0.333,0,0,,9,14,23,4,0,2,5,12,8
2022,New York Liberty,Regular Season,14,AD Durr,25,10,0,70,3,17,0.176,1,9,0.111,2,8,0.25,7,8,0.875,0,1,1,4,4,2,5,4,14
2022,New York Liberty,Playoffs,1,Sabrina Ionescu,24,3,3,93,17,32,0.531,6,15,0.4,11,17,0.647,3,4,0.75,2,16,18,13,3,1,9,7,43
2022,New York Liberty,Playoffs,2,Natasha Howard,30,3,3,83,19,43,0.442,1,10,0.1,18,33,0.545,5,5,1,3,17,20,3,2,0,6,9,44
2022,New York Liberty,Playoffs,3,Stefanie Dolson,30,3,3,79,8,18,0.444,3,5,0.6,5,13,0.385,0,0,,3,8,11,8,0,3,1,7,19
2022,New York Liberty,Playoffs,4,Betnijah Laney,28,3,3,73,13,31,0.419,1,4,0.25,12,27,0.444,7,8,0.875,2,10,12,10,2,1,7,6,34
2022,New York Liberty,Playoffs,5,Marine Johannes,27,3,1,69,6,14,0.429,4,10,0.4,2,4,0.5,1,1,1,0,7,7,13,5,0,6,4,17
2022,New York Liberty,Playoffs,6,Rebecca Allen,29,3,0,49,4,14,0.286,1,6,0.167,3,8,0.375,4,4,1,1,8,9,4,2,1,3,3,13
2022,New York Liberty,Playoffs,7,Sami Whitcomb,33,3,0,44,4,11,0.364,3,7,0.429,1,4,0.25,0,0,,0,1,1,6,3,0,0,2,11
2022,New York Liberty,Playoffs,8,Han Xu,22,3,0,30,5,12,0.417,1,1,1,4,11,0.364,5,6,0.833,2,6,8,1,0,2,2,1,16
2022,New York Liberty,Playoffs,9,Crystal Dangerfield,24,3,2,27,3,11,0.273,1,4,0.25,2,7,0.286,0,0,,0,1,1,1,0,0,2,1,7
2022,New York Liberty,Playoffs,10,Michaela Onyenwere,22,3,0,22,4,11,0.364,0,3,0,4,8,0.5,6,6,1,1,3,4,0,0,0,0,0,14
2022,New York Liberty,Playoffs,11,DiDi Richards,23,2,0,17,2,5,0.4,0,2,0,2,3,0.667,4,4,1,0,3,3,2,2,0,4,2,8
2022,New York Liberty,Playoffs,12,Jocelyn Willoughby,24,2,0,14,2,2,1,0,0,,2,2,1,2,3,0.667,0,1,1,0,0,0,1,1,6
2022,Phoenix Mercury,Regular Season,1,Brianna Turner,25,35,35,1168,68,112,0.607,0,0,,68,112,0.607,15,30,0.5,69,169,238,80,43,56,50,80,151
2022,Phoenix Mercury,Regular Season,2,Skylar Diggins-Smith,31,30,30,1019,208,485,0.429,40,135,0.296,168,350,0.48,135,160,0.844,28,93,121,166,47,29,80,81,591
2022,Phoenix Mercury,Regular Season,3,Shey Peddy,33,34,24,974,117,280,0.418,48,146,0.329,69,134,0.515,56,63,0.889,45,83,128,117,54,7,48,62,338
2022,Phoenix Mercury,Regular Season,4,Diana Taurasi,40,31,31,962,150,402,0.373,92,273,0.337,58,129,0.45,127,142,0.894,8,98,106,119,21,18,84,89,519
2022,Phoenix Mercury,Regular Season,5,Sophie Cunningham,25,28,20,827,120,267,0.449,70,175,0.4,50,92,0.543,42,48,0.875,19,104,123,45,28,10,29,94,352
2022,Phoenix Mercury,Regular Season,6,Diamond DeShields,27,30,19,760,142,366,0.388,21,89,0.236,121,277,0.437,88,115,0.765,18,97,115,67,31,15,70,99,393
2022,Phoenix Mercury,Regular Season,7,Tina Charles,33,16,16,530,104,236,0.441,24,66,0.364,80,170,0.471,44,55,0.8,15,101,116,34,13,12,39,43,276
2022,Phoenix Mercury,Regular Season,8,Megan Gustafson,25,33,0,318,50,91,0.549,12,26,0.462,38,65,0.585,13,17,0.765,17,47,64,17,6,5,24,62,125
2022,Phoenix Mercury,Regular Season,9,Jennie Simms,28,23,4,303,30,63,0.476,4,19,0.211,26,44,0.591,15,19,0.789,13,38,51,20,12,1,24,38,79
2022,Phoenix Mercury,Regular Season,10,Reshanda Gray,29,16,0,152,15,37,0.405,1,11,0.091,14,26,0.538,1,3,0.333,5,24,29,10,5,5,18,37,32
2022,Phoenix Mercury,Regular Season,11,Sam Thomas,23,24,0,118,4,19,0.211,1,15,0.067,3,4,0.75,1,1,1,2,3,5,6,6,2,4,12,10
2022,Phoenix Mercury,Regular Season,12,Kristine Anigwe,25,10,1,65,5,10,0.5,0,0,,5,10,0.5,5,10,0.5,5,8,13,2,1,2,6,12,15
2022,Phoenix Mercury,Regular Season,13,Yvonne Turner,34,3,0,35,4,10,0.4,0,0,,4,10,0.4,2,2,1,0,2,2,7,0,0,0,2,10
2022,Phoenix Mercury,Regular Season,14,Kaela Davis,27,5,0,27,9,13,0.692,2,3,0.667,7,10,0.7,3,4,0.75,2,4,6,0,0,0,3,2,23
2022,Phoenix Mercury,Regular Season,15,Karlie Samuelson,27,1,0,10,1,3,0.333,1,3,0.333,0,0,,0,0,,0,3,3,1,0,0,1,1,3
2022,Phoenix Mercury,Regular Season,16,Emma Cannon,33,1,0,6,1,1,1,0,0,,1,1,1,1,2,0.5,0,2,2,1,0,0,0,0,3
2022,Phoenix Mercury,Playoffs,1,Sophie Cunningham,25,2,2,62,5,11,0.455,3,8,0.375,2,3,0.667,2,6,0.333,1,4,5,4,1,0,5,7,15
2022,Phoenix Mercury,Playoffs,2,Brianna Turner,25,2,2,60,4,9,0.444,0,0,,4,9,0.444,0,0,,11,12,23,5,0,1,2,5,8
2022,Phoenix Mercury,Playoffs,3,Diamond DeShields,27,2,2,54,16,37,0.432,2,6,0.333,14,31,0.452,5,7,0.714,0,9,9,4,2,0,7,2,39
2022,Phoenix Mercury,Playoffs,4,Jennie Simms,28,2,2,49,4,15,0.267,2,10,0.2,2,5,0.4,1,5,0.2,1,5,6,4,0,0,2,4,11
2022,Phoenix Mercury,Playoffs,5,Kaela Davis,27,2,0,47,14,29,0.483,0,3,0,14,26,0.538,4,5,0.8,0,7,7,3,1,1,3,5,32
2022,Phoenix Mercury,Playoffs,6,Megan Gustafson,25,2,0,47,6,19,0.316,0,5,0,6,14,0.429,6,6,1,4,5,9,4,1,1,1,5,18
2022,Phoenix Mercury,Playoffs,7,Shey Peddy,33,1,1,26,3,13,0.231,2,7,0.286,1,6,0.167,0,0,,1,1,2,5,2,0,1,0,8
2022,Phoenix Mercury,Playoffs,8,Yvonne Turner,34,2,1,24,2,7,0.286,0,0,,2,7,0.286,0,0,,2,4,6,3,0,0,0,1,4
2022,Phoenix Mercury,Playoffs,9,Reshanda Gray,29,2,0,16,2,5,0.4,0,0,,2,5,0.4,1,2,0.5,1,1,2,0,0,0,1,1,5
2022,Phoenix Mercury,Playoffs,10,Sam Thomas,23,2,0,14,1,2,0.5,1,2,0.5,0,0,,0,0,,0,0,0,0,1,0,0,0,3
2022,Atlanta Dream,Regular Season,1,Rhyne Howard,22,34,34,1066,184,509,0.361,85,248,0.343,99,261,0.379,99,125,0.792,27,127,154,96,53,26,52,87,552
2022,Atlanta Dream,Regular Season,2,Cheyenne Parker,29,36,35,942,176,352,0.5,12,55,0.218,164,297,0.552,62,78,0.795,59,163,222,71,38,32,73,98,426
2022,Atlanta Dream,Regular Season,3,Aari McDonald,23,36,6,876,131,319,0.411,48,142,0.338,83,177,0.469,88,101,0.871,15,66,81,93,52,1,77,78,398
2022,Atlanta Dream,Regular Season,4,Erica Wheeler,31,30,30,789,98,276,0.355,24,73,0.329,74,203,0.365,31,41,0.756,19,74,93,118,33,2,76,74,251
2022,Atlanta Dream,Regular Season,5,Naz Hillmon,22,34,12,674,59,123,0.48,0,2,0,59,121,0.488,32,39,0.821,52,120,172,41,22,10,40,51,150
2022,Atlanta Dream,Regular Season,6,Kristy Wallace,26,29,18,602,66,162,0.407,25,68,0.368,41,94,0.436,33,42,0.786,18,50,68,63,17,6,44,58,190
2022,Atlanta Dream,Regular Season,7,Kia Vaughn,35,29,1,401,32,80,0.4,0,1,0,32,79,0.405,9,13,0.692,29,63,92,25,10,8,33,50,73
2022,Atlanta Dream,Regular Season,8,Monique Billings,26,23,8,401,55,117,0.47,0,1,0,55,116,0.474,39,51,0.765,45,101,146,26,19,8,31,54,149
2022,Atlanta Dream,Regular Season,9,Nia Coffey,27,16,16,336,35,101,0.347,9,31,0.29,26,70,0.371,23,31,0.742,7,76,83,12,10,2,35,35,102
2022,Atlanta Dream,Regular Season,10,Tiffany Hayes,32,11,11,303,66,121,0.545,18,42,0.429,48,79,0.608,28,41,0.683,3,37,40,23,8,1,22,33,178
2022,Atlanta Dream,Regular Season,11,AD Durr,25,15,2,298,57,135,0.422,22,48,0.458,35,87,0.402,24,31,0.774,7,22,29,26,5,2,17,28,160
2022,Atlanta Dream,Regular Season,12,Maya Caldwell,23,9,7,214,38,74,0.514,18,32,0.563,20,42,0.476,4,5,0.8,5,17,22,20,7,2,14,15,98
2022,Atlanta Dream,Regular Season,13,Beatrice Mompremier,25,21,0,175,20,44,0.455,0,0,,20,44,0.455,5,13,0.385,20,39,59,8,2,12,15,28,45
2022,Atlanta Dream,Regular Season,14,Megan Walker,23,12,0,115,14,38,0.368,7,19,0.368,7,19,0.368,4,6,0.667,3,6,9,5,3,0,12,8,39
2022,Atlanta Dream,Regular Season,15,Destiny Slocum,24,3,0,41,4,11,0.364,3,9,0.333,1,2,0.5,3,5,0.6,0,4,4,4,0,0,5,4,14
2022,Atlanta Dream,Regular Season,16,Yvonne Turner,34,2,0,16,0,1,0,0,0,,0,1,0,1,2,0.5,1,1,2,1,1,0,1,0,1
2022,Atlanta Dream,Regular Season,17,Kaila Charles,24,1,0,2,0,0,,0,0,,0,0,,0,0,,0,0,0,0,0,0,0,1,0
2022,Minnesota Lynx,Regular Season,1,Aerial Powers,28,35,31,943,170,441,0.385,33,107,0.308,137,334,0.41,132,162,0.815,45,118,163,100,42,11,89,63,505
2022,Minnesota Lynx,Regular Season,2,Jessica Shepard,25,36,22,941,108,216,0.5,6,24,0.25,102,192,0.531,69,94,0.734,72,193,265,107,14,12,62,75,291
2022,Minnesota Lynx,Regular Season,3,Kayla McBride,30,31,31,923,137,338,0.405,47,132,0.356,90,206,0.437,90,99,0.909,16,71,87,64,32,2,45,43,411
2022,Minnesota Lynx,Regular Season,4,Sylvia Fowles,36,30,30,831,184,296,0.622,0,0,,184,296,0.622,64,97,0.66,74,221,295,36,31,36,64,73,432
2022,Minnesota Lynx,Regular Season,5,Moriah Jefferson,28,30,30,805,117,259,0.452,36,76,0.474,81,183,0.443,53,65,0.815,11,64,75,147,35,4,67,67,323
2022,Minnesota Lynx,Regular Season,6,Rachel Banham,28,36,5,630,101,235,0.43,57,149,0.383,44,86,0.512,24,30,0.8,3,45,48,81,9,4,48,62,283
2022,Minnesota Lynx,Regular Season,7,Bridget Carleton,25,36,2,606,54,134,0.403,29,82,0.354,25,52,0.481,19,26,0.731,12,65,77,40,16,5,23,56,156
2022,Minnesota Lynx,Regular Season,8,Nikolina Milic,28,31,4,364,74,135,0.548,6,22,0.273,68,113,0.602,31,42,0.738,46,47,93,23,10,8,42,57,185
2022,Minnesota Lynx,Regular Season,9,Natalie Achonwa,29,22,0,332,47,91,0.516,0,2,0,47,89,0.528,22,27,0.815,25,65,90,37,9,7,22,36,116
2022,Minnesota Lynx,Regular Season,10,Damiris Dantas,29,15,15,262,28,92,0.304,16,61,0.262,12,31,0.387,5,6,0.833,10,47,57,28,3,1,16,18,77
2022,Minnesota Lynx,Regular Season,11,Evina Westbrook,23,14,2,173,14,44,0.318,2,14,0.143,12,30,0.4,6,9,0.667,1,19,20,20,6,6,12,14,36
2022,Minnesota Lynx,Regular Season,12,Lindsay Allen,27,9,0,134,20,38,0.526,8,14,0.571,12,24,0.5,12,13,0.923,0,14,14,31,2,0,7,11,60
2022,Minnesota Lynx,Regular Season,13,Napheesa Collier,25,4,4,91,11,26,0.423,2,7,0.286,9,19,0.474,5,7,0.714,2,10,12,4,2,1,1,9,29
2022,Minnesota Lynx,Regular Season,14,Yvonne Turner,34,4,2,88,8,26,0.308,3,7,0.429,5,19,0.263,6,7,0.857,2,8,10,10,2,0,12,10,25
2022,Minnesota Lynx,Regular Season,15,Odyssey Sims,29,2,0,54,7,23,0.304,1,4,0.25,6,19,0.316,4,9,0.444,1,6,7,7,1,2,5,4,19
2022,Minnesota Lynx,Regular Season,16,Kamiah Smalls,24,3,0,34,2,8,0.25,0,4,0,2,4,0.5,0,0,,0,5,5,6,4,0,4,6,4
2022,Minnesota Lynx,Regular Season,17,Angel McCoughtry,35,2,2,20,3,8,0.375,0,1,0,3,7,0.429,6,6,1,0,6,6,2,1,2,3,3,12
2022,Minnesota Lynx,Regular Season,18,Elissa Cunane,21,3,0,10,1,2,0.5,0,1,0,1,1,1,0,0,,2,3,5,0,0,0,1,1,2
2022,Minnesota Lynx,Regular Season,19,Hannah Sjerven,24,3,0,9,0,1,0,0,0,,0,1,0,0,0,,0,0,0,0,0,1,0,2,0
2022,Minnesota Lynx,Regular Season,20,Rennia Davis,23,1,0,3,1,1,1,0,0,,1,1,1,0,0,,0,0,0,0,0,0,1,0,2
2022,Los Angeles Sparks,Regular Season,1,Nneka Ogwumike,31,34,34,1068,249,458,0.544,21,57,0.368,228,401,0.569,95,115,0.826,48,177,225,68,56,15,62,80,614
2022,Los Angeles Sparks,Regular Season,2,Katie Lou Samuelson,25,32,29,943,107,287,0.373,56,159,0.352,51,128,0.398,41,49,0.837,17,78,95,62,33,7,34,52,311
2022,Los Angeles Sparks,Regular Season,3,Brittney Sykes,28,32,24,921,152,351,0.433,14,52,0.269,138,299,0.462,87,113,0.77,23,94,117,118,65,22,84,84,405
2022,Los Angeles Sparks,Regular Season,4,Jordin Canada,26,32,25,865,104,271,0.384,7,50,0.14,97,221,0.439,79,98,0.806,7,66,73,176,44,5,75,58,294
2022,Los Angeles Sparks,Regular Season,5,Lexie Brown,27,34,16,850,93,211,0.441,53,133,0.398,40,78,0.513,4,6,0.667,8,70,78,70,34,7,28,44,243
2022,Los Angeles Sparks,Regular Season,6,Liz Cambage,30,25,24,584,117,230,0.509,4,14,0.286,113,216,0.523,87,111,0.784,33,127,160,52,16,41,57,79,325
2022,Los Angeles Sparks,Regular Season,7,Chiney Ogwumike,30,26,7,478,69,148,0.466,8,18,0.444,61,130,0.469,36,51,0.706,52,90,142,28,20,9,37,71,182
2022,Los Angeles Sparks,Regular Season,8,Olivia Nelson-Ododa,21,30,6,436,47,83,0.566,0,0,,47,83,0.566,26,37,0.703,34,54,88,11,9,24,31,77,120
2022,Los Angeles Sparks,Regular Season,9,Chennedy Carter,23,24,2,393,85,189,0.45,2,10,0.2,83,179,0.464,41,55,0.745,9,36,45,46,15,9,43,52,213
2022,Los Angeles Sparks,Regular Season,10,Jasmine Walker,24,32,1,281,19,76,0.25,10,50,0.2,9,26,0.346,3,3,1,12,36,48,6,6,3,15,30,51
2022,Los Angeles Sparks,Regular Season,11,Kristi Toliver,35,11,10,218,19,51,0.373,13,36,0.361,6,15,0.4,14,16,0.875,0,9,9,34,4,0,25,14,65
2022,Los Angeles Sparks,Regular Season,12,Kianna Smith,23,11,0,113,11,35,0.314,5,18,0.278,6,17,0.353,2,2,1,5,4,9,6,4,0,4,11,29
2022,Los Angeles Sparks,Regular Season,13,Rae Burrell,22,3,1,44,1,9,0.111,1,6,0.167,0,3,0,2,2,1,1,2,3,1,2,0,1,4,5
2022,Los Angeles Sparks,Regular Season,14,Amy Atwell,24,4,1,32,1,9,0.111,1,6,0.167,0,3,0,0,0,,1,1,2,2,0,0,2,1,3
2022,Indiana Fever,Regular Season,1,Kelsey Mitchell,26,31,31,1010,196,447,0.438,72,176,0.409,124,271,0.458,105,122,0.861,14,46,60,129,29,7,73,72,569
2022,Indiana Fever,Regular Season,2,NaLyssa Smith,21,32,32,983,160,382,0.419,37,97,0.381,123,285,0.432,76,123,0.618,70,183,253,45,15,8,76,93,433
2022,Indiana Fever,Regular Season,3,Victoria Vivians,27,35,30,940,126,375,0.336,44,157,0.28,82,218,0.376,46,62,0.742,23,102,125,85,37,9,72,83,342
2022,Indiana Fever,Regular Season,4,Danielle Robinson,33,31,30,732,85,203,0.419,9,40,0.225,76,163,0.466,51,60,0.85,12,77,89,119,22,5,51,44,230
2022,Indiana Fever,Regular Season,5,Queen Egbo,22,33,31,720,95,215,0.442,0,0,,95,215,0.442,49,76,0.645,61,148,209,31,30,40,64,98,239
2022,Indiana Fever,Regular Season,6,Emily Engstler,22,35,6,638,72,182,0.396,16,45,0.356,56,137,0.409,21,38,0.553,72,109,181,51,26,40,48,110,181
2022,Indiana Fever,Regular Season,7,Destanni Henderson,23,36,5,589,71,177,0.401,26,71,0.366,45,106,0.425,23,32,0.719,27,30,57,89,27,3,60,32,191
2022,Indiana Fever,Regular Season,8,Tiffany Mitchell,27,34,8,553,82,182,0.451,12,31,0.387,70,151,0.464,45,52,0.865,20,21,41,40,28,2,30,46,221
2022,Indiana Fever,Regular Season,9,Lexie Hull,22,26,4,334,28,105,0.267,8,43,0.186,20,62,0.323,36,40,0.9,11,29,40,18,15,2,18,47,100
2022,Indiana Fever,Regular Season,10,Emma Cannon,33,23,2,328,59,113,0.522,9,18,0.5,50,95,0.526,34,46,0.739,22,51,73,12,14,2,16,48,161
2022,Indiana Fever,Regular Season,11,Alanna Smith,25,9,1,116,14,42,0.333,6,25,0.24,8,17,0.471,5,7,0.714,8,16,24,5,8,6,8,17,39
2022,Indiana Fever,Regular Season,12,Bria Hartley,29,10,0,87,9,26,0.346,3,9,0.333,6,17,0.353,4,6,0.667,1,9,10,10,1,0,9,5,25
2022,Indiana Fever,Regular Season,13,Alaina Coates,27,8,0,75,7,11,0.636,0,0,,7,11,0.636,14,15,0.933,6,10,16,2,2,3,5,18,28
2022,Indiana Fever,Regular Season,14,Khayla Pointer,23,10,0,58,7,12,0.583,1,4,0.25,6,8,0.75,7,14,0.5,1,7,8,2,2,0,9,2,22
2022,Indiana Fever,Regular Season,15,Crystal Dangerfield,24,3,0,49,6,14,0.429,2,6,0.333,4,8,0.5,4,4,1,1,2,3,10,0,2,3,1,18
2022,Indiana Fever,Regular Season,16,Rennia Davis,23,7,0,40,4,12,0.333,0,2,0,4,10,0.4,0,0,,3,5,8,1,2,0,3,3,8
2021,Connecticut Sun,Regular Season,1,DeWanna Bonner,33,32,32,1022,159,403,0.395,44,139,0.317,115,264,0.436,124,139,0.892,21,184,205,111,40,23,69,52,486
2021,Connecticut Sun,Regular Season,2,Brionna Jones,25,32,32,980,194,340,0.571,0,3,0,194,337,0.576,82,103,0.796,101,132,233,56,44,17,70,97,470
2021,Connecticut Sun,Regular Season,3,Jasmine Thomas,31,30,30,887,113,293,0.386,42,105,0.4,71,188,0.378,49,56,0.875,13,60,73,122,39,6,67,53,317
2021,Connecticut Sun,Regular Season,4,Briann January,34,29,29,877,71,167,0.425,27,71,0.38,44,96,0.458,33,38,0.868,9,33,42,89,25,4,52,58,202
2021,Connecticut Sun,Regular Season,5,Jonquel Jones,27,27,27,856,192,373,0.515,42,116,0.362,150,257,0.584,97,121,0.802,67,236,303,75,34,34,78,84,523
2021,Connecticut Sun,Regular Season,6,Natisha Hiedeman,24,32,5,644,78,195,0.4,51,128,0.398,27,67,0.403,35,50,0.7,7,53,60,60,27,6,30,61,242
2021,Connecticut Sun,Regular Season,7,Kaila Charles,23,30,4,488,49,133,0.368,10,33,0.303,39,100,0.39,21,24,0.875,33,51,84,33,14,11,26,59,129
2021,Connecticut Sun,Regular Season,8,Beatrice Mompremier,24,32,0,275,26,53,0.491,0,0,,26,53,0.491,5,12,0.417,28,49,77,7,12,8,18,44,57
2021,Connecticut Sun,Regular Season,9,DiJonai Carrington,23,24,1,220,27,82,0.329,3,21,0.143,24,61,0.393,11,15,0.733,15,32,47,12,13,3,22,37,68
2021,Connecticut Sun,Regular Season,10,Stephanie Jones,22,18,0,99,12,29,0.414,0,2,0,12,27,0.444,1,2,0.5,11,10,21,3,2,1,3,9,25
2021,Connecticut Sun,Regular Season,11,Emma Cannon,32,5,0,58,8,17,0.471,4,8,0.5,4,9,0.444,1,2,0.5,5,10,15,4,0,1,5,10,21
2021,Connecticut Sun,Regular Season,12,Alyssa Thomas,29,3,0,37,4,15,0.267,0,0,,4,15,0.267,3,4,0.75,1,9,10,4,1,0,3,4,11
2021,Connecticut Sun,Regular Season,13,Shatori Walker-Kimbrough,26,1,0,4,0,0,,0,0,,0,0,,0,0,,0,1,1,0,0,1,1,1,0
2021,Connecticut Sun,Regular Season,14,Aleah Goodman,22,1,0,3,0,0,,0,0,,0,0,,0,0,,0,0,0,1,0,0,0,1,0
2021,Connecticut Sun,Playoffs,1,DeWanna Bonner,33,4,4,140,19,47,0.404,6,15,0.4,13,32,0.406,10,11,0.909,3,25,28,5,4,7,11,11,54
2021,Connecticut Sun,Playoffs,2,Jonquel Jones,27,4,4,140,27,59,0.458,4,9,0.444,23,50,0.46,7,9,0.778,10,29,39,13,5,9,8,6,65
2021,Connecticut Sun,Playoffs,3,Jasmine Thomas,31,4,4,137,11,43,0.256,4,18,0.222,7,25,0.28,7,9,0.778,6,7,13,14,8,2,13,8,33
2021,Connecticut Sun,Playoffs,4,Brionna Jones,25,4,4,103,19,32,0.594,0,0,,19,32,0.594,9,14,0.643,7,10,17,2,6,3,6,11,47
2021,Connecticut Sun,Playoffs,5,Briann January,34,3,3,102,9,17,0.529,5,8,0.625,4,9,0.444,9,13,0.692,1,6,7,9,3,0,5,9,32
2021,Connecticut Sun,Playoffs,6,Alyssa Thomas,29,4,0,93,20,49,0.408,0,1,0,20,48,0.417,7,11,0.636,10,14,24,15,6,2,5,9,47
2021,Connecticut Sun,Playoffs,7,Natisha Hiedeman,24,4,0,72,11,22,0.5,9,15,0.6,2,7,0.286,5,7,0.714,2,1,3,12,3,2,2,2,36
2021,Connecticut Sun,Playoffs,8,Kaila Charles,23,4,1,53,5,16,0.313,0,1,0,5,15,0.333,0,0,,8,4,12,3,1,1,1,3,10
2021,Connecticut Sun,Playoffs,9,Beatrice Mompremier,24,2,0,7,1,2,0.5,0,0,,1,2,0.5,0,0,,0,2,2,1,0,0,1,0,2
2021,Connecticut Sun,Playoffs,10,DiJonai Carrington,23,2,0,1,0,0,,0,0,,0,0,,0,0,,0,0,0,0,0,0,0,0,0
2021,Connecticut Sun,Playoffs,11,Stephanie Jones,22,1,0,1,0,0,,0,0,,0,0,,0,0,,0,0,0,0,0,0,0,0,0
2021,Las Vegas Aces,Regular Season,1,A'ja Wilson,24,32,32,1021,207,466,0.444,1,1,1,206,465,0.443,169,193,0.876,63,235,298,98,28,40,46,49,584
2021,Las Vegas Aces,Regular Season,2,Jackie Young,23,32,32,1016,155,306,0.507,5,20,0.25,150,286,0.524,75,90,0.833,20,110,130,103,36,11,47,58,390
2021,Las Vegas Aces,Regular Season,3,Chelsea Gray,28,32,32,926,148,326,0.454,27,71,0.38,121,255,0.475,32,36,0.889,15,77,92,189,37,9,88,43,355
2021,Las Vegas Aces,Regular Season,4,Riquna Williams,31,32,32,833,114,257,0.444,63,151,0.417,51,106,0.481,46,50,0.92,6,77,83,51,25,11,21,47,337
2021,Las Vegas Aces,Regular Season,5,Dearica Hamby,27,29,0,710,127,233,0.545,9,36,0.25,118,197,0.599,74,113,0.655,33,160,193,49,31,4,43,57,337
2021,Las Vegas Aces,Regular Season,6,Kelsey Plum,26,26,0,665,128,293,0.437,44,114,0.386,84,179,0.469,85,90,0.944,11,55,66,93,26,1,43,56,385
2021,Las Vegas Aces,Regular Season,7,Liz Cambage,29,25,24,595,140,258,0.543,5,14,0.357,135,244,0.553,71,100,0.71,39,167,206,33,22,41,44,74,356
2021,Las Vegas Aces,Regular Season,8,Kiah Stokes,28,15,8,308,10,17,0.588,0,0,,10,17,0.588,2,4,0.5,27,65,92,15,6,10,7,19,22
2021,Las Vegas Aces,Regular Season,9,JiSu Park,22,25,0,223,17,52,0.327,0,4,0,17,48,0.354,15,18,0.833,16,30,46,21,3,16,19,28,49
2021,Las Vegas Aces,Regular Season,10,Destiny Slocum,23,21,0,133,7,22,0.318,5,15,0.333,2,7,0.286,3,5,0.6,3,16,19,12,3,1,7,19,22
2021,Las Vegas Aces,Regular Season,11,Joyner Holmes,23,4,0,23,5,10,0.5,3,4,0.75,2,6,0.333,0,0,,0,4,4,2,0,1,1,2,13
2021,Las Vegas Aces,Regular Season,12,Emma Cannon,32,3,0,17,2,5,0.4,0,2,0,2,3,0.667,2,2,1,2,3,5,1,0,1,3,3,6
2021,Las Vegas Aces,Regular Season,13,Bria Holmes,27,2,0,6,0,1,0,0,0,,0,1,0,0,0,,0,2,2,0,0,0,1,0,0
2021,Las Vegas Aces,Regular Season,14,Angel McCoughtry,34,1,0,0,0,1,0,0,0,,0,1,0,0,0,,0,0,0,0,0,0,0,0,0
2021,Las Vegas Aces,Playoffs,1,A'ja Wilson,24,5,5,161,27,62,0.435,0,0,,27,62,0.435,17,26,0.654,6,40,46,16,5,5,11,8,71
2021,Las Vegas Aces,Playoffs,2,Kelsey Plum,26,5,0,144,33,70,0.471,12,31,0.387,21,39,0.538,20,22,0.909,2,8,10,17,5,0,12,11,98
2021,Las Vegas Aces,Playoffs,3,Chelsea Gray,28,5,5,142,30,65,0.462,7,18,0.389,23,47,0.489,10,10,1,1,15,16,32,5,0,6,5,77
2021,Las Vegas Aces,Playoffs,4,Riquna Williams,31,5,5,137,27,49,0.551,10,29,0.345,17,20,0.85,8,8,1,0,8,8,5,6,2,3,8,72
2021,Las Vegas Aces,Playoffs,5,Jackie Young,23,5,5,130,11,33,0.333,0,1,0,11,32,0.344,6,6,1,9,7,16,11,5,2,3,12,28
2021,Las Vegas Aces,Playoffs,6,Liz Cambage,29,5,3,100,21,43,0.488,3,6,0.5,18,37,0.486,7,7,1,5,22,27,6,9,1,8,17,52
2021,Las Vegas Aces,Playoffs,7,Dearica Hamby,27,5,0,87,7,24,0.292,0,5,0,7,19,0.368,5,10,0.5,7,17,24,5,2,1,2,11,19
2021,Las Vegas Aces,Playoffs,8,Kiah Stokes,28,5,2,71,2,5,0.4,0,0,,2,5,0.4,1,2,0.5,4,9,13,5,2,3,2,7,5
2021,Las Vegas Aces,Playoffs,9,JiSu Park,22,4,0,16,0,3,0,0,0,,0,3,0,0,4,0,0,1,1,0,0,0,1,2,0
2021,Las Vegas Aces,Playoffs,10,Destiny Slocum,23,3,0,13,1,2,0.5,0,1,0,1,1,1,0,0,,0,0,0,0,0,0,0,0,2
2021,Minnesota Lynx,Regular Season,1,Kayla McBride,29,32,32,1010,143,330,0.433,61,161,0.379,82,169,0.485,91,100,0.91,8,107,115,72,26,5,34,57,438
2021,Minnesota Lynx,Regular Season,2,Napheesa Collier,24,29,29,1003,175,397,0.441,21,83,0.253,154,314,0.49,98,114,0.86,50,142,192,92,38,37,68,82,469
2021,Minnesota Lynx,Regular Season,3,Sylvia Fowles,35,31,31,934,208,325,0.64,0,0,,208,325,0.64,80,106,0.755,65,247,312,44,56,56,72,79,496
2021,Minnesota Lynx,Regular Season,4,Crystal Dangerfield,23,31,10,623,87,224,0.388,28,78,0.359,59,146,0.404,36,42,0.857,8,53,61,88,21,2,43,58,238
2021,Minnesota Lynx,Regular Season,5,Bridget Carleton,24,32,10,618,55,137,0.401,27,74,0.365,28,63,0.444,16,20,0.8,23,51,74,47,25,6,27,47,153
2021,Minnesota Lynx,Regular Season,6,Damiris Dantas,28,24,20,572,66,175,0.377,34,102,0.333,32,73,0.438,18,24,0.75,15,82,97,55,10,7,44,48,184
2021,Minnesota Lynx,Regular Season,7,Layshia Clarendon,30,21,20,540,92,178,0.517,5,14,0.357,87,164,0.53,29,37,0.784,12,53,65,119,13,0,64,59,218
2021,Minnesota Lynx,Regular Season,8,Rachel Banham,27,27,0,341,51,129,0.395,28,75,0.373,23,54,0.426,5,8,0.625,3,30,33,44,8,4,25,47,135
2021,Minnesota Lynx,Regular Season,9,Aerial Powers,27,14,7,309,61,143,0.427,11,35,0.314,50,108,0.463,55,60,0.917,13,38,51,29,5,5,41,29,188
2021,Minnesota Lynx,Regular Season,10,Natalie Achonwa,28,21,1,253,26,61,0.426,0,1,0,26,60,0.433,25,28,0.893,12,33,45,25,12,5,13,33,77
2021,Minnesota Lynx,Regular Season,11,Jessica Shepard,24,22,0,231,16,44,0.364,1,12,0.083,15,32,0.469,12,16,0.75,24,47,71,38,3,4,18,20,45
2021,Minnesota Lynx,Regular Season,12,Cierra Burdick,27,3,0,10,2,3,0.667,0,0,,2,3,0.667,2,3,0.667,0,1,1,0,0,0,0,0,6
2021,Minnesota Lynx,Regular Season,13,Linnae Harper,26,1,0,5,0,0,,0,0,,0,0,,0,0,,0,1,1,0,0,0,0,2,0
2021,Minnesota Lynx,Regular Season,14,Natasha Mack,23,1,0,2,0,0,,0,0,,0,0,,0,0,,0,0,0,0,0,0,0,0,0
2021,Minnesota Lynx,Playoffs,1,Napheesa Collier,24,1,1,35,3,11,0.273,2,2,1,1,9,0.111,0,0,,3,1,4,2,3,0,2,4,8
2021,Minnesota Lynx,Playoffs,2,Kayla McBride,29,1,1,34,7,13,0.538,4,7,0.571,3,6,0.5,1,2,0.5,0,7,7,2,0,0,6,3,19
2021,Minnesota Lynx,Playoffs,3,Sylvia Fowles,35,1,1,32,6,9,0.667,0,0,,6,9,0.667,5,6,0.833,2,6,8,2,1,2,1,6,17
2021,Minnesota Lynx,Playoffs,4,Aerial Powers,27,1,1,32,10,21,0.476,3,6,0.5,7,15,0.467,1,1,1,1,4,5,4,2,0,6,4,24
2021,Minnesota Lynx,Playoffs,5,Crystal Dangerfield,23,1,0,24,1,5,0.2,0,2,0,1,3,0.333,0,0,,0,1,1,2,1,0,2,1,2
2021,Minnesota Lynx,Playoffs,6,Bridget Carleton,24,1,0,15,0,2,0,0,0,,0,2,0,0,0,,0,0,0,2,0,0,0,1,0
2021,Minnesota Lynx,Playoffs,7,Layshia Clarendon,30,1,1,12,0,1,0,0,1,0,0,0,,0,0,,0,1,1,0,1,0,1,1,0
2021,Minnesota Lynx,Playoffs,8,Natalie Achonwa,28,1,0,11,2,3,0.667,0,0,,2,3,0.667,0,0,,0,2,2,0,0,0,1,0,4
2021,Minnesota Lynx,Playoffs,9,Rachel Banham,27,1,0,5,0,2,0,0,0,,0,2,0,2,2,1,0,1,1,1,0,0,1,0,2
2021,Seattle Storm,Regular Season,1,Jewell Loyd,27,31,31,962,193,459,0.42,65,173,0.376,128,286,0.448,104,117,0.889,24,101,125,117,46,6,71,64,555
2021,Seattle Storm,Regular Season,2,Breanna Stewart,26,28,28,934,194,442,0.439,48,143,0.336,146,299,0.488,133,157,0.847,34,234,268,76,33,48,46,51,569
2021,Seattle Storm,Regular Season,3,Sue Bird,40,30,30,832,106,246,0.431,67,160,0.419,39,86,0.453,20,24,0.833,8,69,77,160,28,3,47,31,299
2021,Seattle Storm,Regular Season,4,Mercedes Russell,25,30,28,740,92,149,0.617,0,0,,92,149,0.617,36,47,0.766,50,134,184,49,27,11,38,79,220
2021,Seattle Storm,Regular Season,5,Katie Lou Samuelson,24,27,24,566,72,158,0.456,26,74,0.351,46,84,0.548,19,26,0.731,11,84,95,46,18,7,30,45,189
2021,Seattle Storm,Regular Season,6,Jordin Canada,25,29,3,542,56,144,0.389,3,14,0.214,53,130,0.408,53,63,0.841,16,50,66,88,21,4,31,29,168
2021,Seattle Storm,Regular Season,7,Stephanie Talbot,27,30,9,538,69,143,0.483,27,65,0.415,42,78,0.538,6,8,0.75,12,74,86,48,14,13,49,58,171
2021,Seattle Storm,Regular Season,8,Ezi Magbegor,21,30,3,456,81,160,0.506,5,9,0.556,76,151,0.503,33,39,0.846,46,70,116,24,18,29,26,65,200
2021,Seattle Storm,Regular Season,9,Epiphanny Prince,33,29,2,416,58,132,0.439,25,50,0.5,33,82,0.402,26,29,0.897,10,37,47,48,20,6,25,33,167
2021,Seattle Storm,Regular Season,10,Candice Dupree,36,16,2,260,41,94,0.436,1,4,0.25,40,90,0.444,11,11,1,8,32,40,11,7,3,13,21,94
2021,Seattle Storm,Regular Season,11,Kennedy Burke,24,23,0,176,25,56,0.446,6,18,0.333,19,38,0.5,10,16,0.625,7,12,19,7,6,3,11,13,66
2021,Seattle Storm,Regular Season,12,Cierra Burdick,27,7,0,35,1,4,0.25,0,0,,1,4,0.25,1,2,0.5,4,8,12,3,2,2,2,4,3
2021,Seattle Storm,Regular Season,13,Kiana Williams,22,10,0,35,1,7,0.143,1,6,0.167,0,1,0,1,1,1,0,4,4,2,1,0,2,3,4
2021,Seattle Storm,Regular Season,14,Karlie Samuelson,26,3,0,32,3,10,0.3,1,8,0.125,2,2,1,2,2,1,0,1,1,2,0,0,3,1,9
2021,Seattle Storm,Regular Season,15,Mikiah Herbert Harrigan,22,1,0,1,0,0,,0,0,,0,0,,0,0,,0,0,0,0,0,0,0,0,0
2021,Seattle Storm,Playoffs,1,Mercedes Russell,25,1,1,45,5,9,0.556,0,0,,5,9,0.556,0,0,,2,10,12,4,0,2,0,2,10
2021,Seattle Storm,Playoffs,2,Sue Bird,40,1,1,37,5,12,0.417,4,8,0.5,1,4,0.25,2,2,1,0,3,3,5,1,0,2,1,16
2021,Seattle Storm,Playoffs,3,Jewell Loyd,27,1,1,36,5,24,0.208,0,7,0,5,17,0.294,5,5,1,0,3,3,5,1,2,3,5,15
2021,Seattle Storm,Playoffs,4,Katie Lou Samuelson,24,1,1,35,6,10,0.6,4,6,0.667,2,4,0.5,2,2,1,0,5,5,0,1,0,1,5,18
2021,Seattle Storm,Playoffs,5,Ezi Magbegor,21,1,1,31,4,9,0.444,1,1,1,3,8,0.375,0,0,,3,6,9,2,0,1,1,5,9
2021,Seattle Storm,Playoffs,6,Stephanie Talbot,27,1,0,17,3,6,0.5,0,2,0,3,4,0.75,0,1,0,1,3,4,0,1,1,0,2,6
2021,Seattle Storm,Playoffs,7,Jordin Canada,25,1,0,10,0,3,0,0,0,,0,3,0,6,6,1,0,0,0,2,1,0,3,0,6
2021,Seattle Storm,Playoffs,8,Epiphanny Prince,33,1,0,9,0,3,0,0,1,0,0,2,0,0,0,,0,0,0,1,0,1,2,1,0
2021,Seattle Storm,Playoffs,9,Kennedy Burke,24,1,0,5,0,0,,0,0,,0,0,,0,0,,0,3,3,0,0,0,1,0,0
2021,Phoenix Mercury,Regular Season,1,Skylar Diggins-Smith,30,32,32,1040,177,393,0.45,50,135,0.37,127,258,0.492,162,198,0.818,17,84,101,168,34,25,82,71,566
2021,Phoenix Mercury,Regular Season,2,Brianna Turner,24,32,32,994,108,195,0.554,0,1,0,108,194,0.557,33,46,0.717,78,224,302,56,24,42,47,70,249
2021,Phoenix Mercury,Regular Season,3,Brittney Griner,30,30,30,983,248,431,0.575,4,9,0.444,244,422,0.578,115,136,0.846,71,213,284,80,12,58,66,72,615
2021,Phoenix Mercury,Regular Season,4,Kia Nurse,25,32,32,835,98,273,0.359,59,167,0.353,39,106,0.368,49,62,0.79,14,99,113,56,17,2,48,72,304
2021,Phoenix Mercury,Regular Season,5,Shey Peddy,32,32,5,560,61,148,0.412,27,81,0.333,34,67,0.507,23,25,0.92,24,51,75,79,29,3,31,33,172
2021,Phoenix Mercury,Regular Season,6,Sophie Cunningham,24,30,4,524,59,135,0.437,32,78,0.41,27,57,0.474,19,27,0.704,9,51,60,32,14,7,16,56,169
2021,Phoenix Mercury,Regular Season,7,Diana Taurasi,39,16,16,455,70,191,0.366,41,121,0.339,29,70,0.414,62,72,0.861,3,68,71,79,3,9,47,38,243
2021,Phoenix Mercury,Regular Season,8,Kia Vaughn,34,28,2,441,59,133,0.444,0,1,0,59,132,0.447,12,20,0.6,23,53,76,36,5,6,36,44,130
2021,Phoenix Mercury,Regular Season,9,Megan Walker,22,29,7,426,46,148,0.311,20,75,0.267,26,73,0.356,19,30,0.633,6,33,39,25,5,8,23,52,131
2021,Phoenix Mercury,Regular Season,10,Alanna Smith,24,18,0,117,8,34,0.235,4,21,0.19,4,13,0.308,1,4,0.25,5,19,24,10,7,6,6,10,21
2021,Phoenix Mercury,Regular Season,11,Bria Hartley,28,6,0,51,9,16,0.563,4,7,0.571,5,9,0.556,0,0,,2,2,4,5,1,0,5,1,22
2021,Phoenix Mercury,Regular Season,12,Cierra Burdick,27,4,0,19,2,4,0.5,0,0,,2,4,0.5,0,0,,3,4,7,3,1,1,1,2,4
2021,Phoenix Mercury,Regular Season,13,Haley Gorecki,24,3,0,6,0,1,0,0,1,0,0,0,,0,0,,0,2,2,0,0,0,1,0,0
2021,Phoenix Mercury,Playoffs,1,Brittney Griner,30,11,11,386,100,178,0.562,0,4,0,100,174,0.575,40,50,0.8,18,74,92,33,4,18,23,20,240
2021,Phoenix Mercury,Playoffs,2,Skylar Diggins-Smith,30,11,11,384,57,155,0.368,19,61,0.311,38,94,0.404,20,27,0.741,12,28,40,67,11,5,25,28,153
2021,Phoenix Mercury,Playoffs,3,Brianna Turner,24,11,11,346,40,73,0.548,0,0,,40,73,0.548,13,19,0.684,36,73,109,28,14,21,13,28,93
2021,Phoenix Mercury,Playoffs,4,Diana Taurasi,39,10,10,305,52,133,0.391,34,98,0.347,18,35,0.514,38,43,0.884,2,33,35,29,5,6,30,31,176
2021,Phoenix Mercury,Playoffs,5,Shey Peddy,32,11,4,255,26,68,0.382,8,31,0.258,18,37,0.486,13,18,0.722,13,26,39,27,22,0,10,20,73
2021,Phoenix Mercury,Playoffs,6,Kia Vaughn,34,11,0,141,15,52,0.288,0,1,0,15,51,0.294,2,2,1,4,20,24,13,4,0,12,15,32
2021,Phoenix Mercury,Playoffs,7,Sophie Cunningham,24,8,2,140,15,31,0.484,13,23,0.565,2,8,0.25,8,8,1,2,15,17,6,2,7,6,11,51
2021,Phoenix Mercury,Playoffs,8,Kia Nurse,25,6,6,131,16,37,0.432,10,22,0.455,6,15,0.4,8,8,1,3,17,20,9,1,0,4,15,50
2021,Phoenix Mercury,Playoffs,9,Bria Hartley,28,10,0,96,8,26,0.308,3,11,0.273,5,15,0.333,6,6,1,0,14,14,13,1,0,7,10,25
2021,Phoenix Mercury,Playoffs,10,Megan Walker,22,5,0,39,2,7,0.286,0,4,0,2,3,0.667,4,4,1,1,3,4,0,1,0,6,4,8
2021,Phoenix Mercury,Playoffs,11,Alanna Smith,24,5,0,26,6,15,0.4,2,5,0.4,4,10,0.4,2,2,1,5,5,10,1,1,1,2,2,16
2021,Chicago Sky,Regular Season,1,Kahleah Copper,26,32,32,986,173,377,0.459,26,85,0.306,147,292,0.503,90,110,0.818,37,96,133,56,27,8,60,96,462
2021,Chicago Sky,Regular Season,2,Courtney Vandersloot,32,32,32,977,129,298,0.433,36,104,0.346,93,194,0.479,42,49,0.857,16,93,109,275,54,12,97,66,336
2021,Chicago Sky,Regular Season,3,Diamond DeShields,26,32,22,860,123,313,0.393,24,80,0.3,99,233,0.425,91,111,0.82,13,99,112,75,38,12,60,101,361
2021,Chicago Sky,Regular Season,4,Allie Quigley,35,26,11,635,121,270,0.448,54,119,0.454,67,151,0.444,47,49,0.959,17,52,69,60,13,7,30,37,343
2021,Chicago Sky,Regular Season,5,Candace Parker,35,23,23,615,116,253,0.458,24,73,0.329,92,180,0.511,50,63,0.794,32,161,193,91,19,27,56,37,306
2021,Chicago Sky,Regular Season,6,Azura Stevens,25,30,11,587,90,180,0.5,15,45,0.333,75,135,0.556,26,32,0.813,49,88,137,23,24,20,28,54,221
2021,Chicago Sky,Regular Season,7,Ruthy Hebard,23,30,6,505,73,138,0.529,0,2,0,73,136,0.537,27,34,0.794,42,90,132,23,20,20,18,59,173
2021,Chicago Sky,Regular Season,8,Stefanie Dolson,29,24,15,480,71,146,0.486,19,47,0.404,52,99,0.525,18,19,0.947,16,68,84,30,6,19,30,64,179
2021,Chicago Sky,Regular Season,9,Astou Ndour-Fall,26,20,8,342,46,116,0.397,8,34,0.235,38,82,0.463,32,34,0.941,32,63,95,8,7,16,17,43,132
2021,Chicago Sky,Regular Season,10,Dana Evans,22,23,0,197,26,73,0.356,17,42,0.405,9,31,0.29,21,24,0.875,1,10,11,27,5,1,13,18,90
2021,Chicago Sky,Regular Season,11,Lexie Brown,26,17,0,162,10,38,0.263,8,33,0.242,2,5,0.4,0,0,,0,12,12,19,7,0,8,11,28
2021,Chicago Sky,Regular Season,12,Stephanie Watts,24,6,0,84,4,19,0.211,1,10,0.1,3,9,0.333,6,8,0.75,8,14,22,3,3,2,8,13,15
2021,Chicago Sky,Regular Season,13,Shyla Heal,19,4,0,31,1,8,0.125,0,3,0,1,5,0.2,6,6,1,1,2,3,3,0,0,10,6,8
2021,Chicago Sky,Regular Season,14,Brittany Boyd,28,2,0,22,1,4,0.25,1,2,0.5,0,2,0,1,2,0.5,0,2,2,4,2,0,4,2,4
2021,Chicago Sky,Regular Season,15,Natasha Mack,23,3,0,16,2,3,0.667,0,0,,2,3,0.667,2,2,1,1,3,4,0,0,0,2,2,6
2021,Chicago Sky,Playoffs,1,Courtney Vandersloot,32,10,10,344,53,104,0.51,8,24,0.333,45,80,0.563,16,19,0.842,8,46,54,102,15,8,35,12,130
2021,Chicago Sky,Playoffs,2,Kahleah Copper,26,10,10,328,66,127,0.52,11,32,0.344,55,95,0.579,34,43,0.791,18,35,53,19,12,2,20,20,177
2021,Chicago Sky,Playoffs,3,Allie Quigley,35,10,10,327,50,120,0.417,27,74,0.365,23,46,0.5,25,25,1,6,23,29,18,6,3,14,19,152
2021,Chicago Sky,Playoffs,4,Candace Parker,35,10,10,324,55,112,0.491,11,33,0.333,44,79,0.557,17,19,0.895,11,73,84,44,21,10,23,20,138
2021,Chicago Sky,Playoffs,5,Azura Stevens,25,10,10,254,41,86,0.477,5,19,0.263,36,67,0.537,11,14,0.786,26,43,69,8,7,8,9,31,98
2021,Chicago Sky,Playoffs,6,Stefanie Dolson,29,10,0,168,21,41,0.512,5,17,0.294,16,24,0.667,2,2,1,3,25,28,11,2,7,11,22,49
2021,Chicago Sky,Playoffs,7,Diamond DeShields,26,10,0,157,18,53,0.34,3,12,0.25,15,41,0.366,16,20,0.8,9,18,27,11,11,1,16,15,55
2021,Chicago Sky,Playoffs,8,Astou Ndour-Fall,26,9,0,69,8,19,0.421,1,5,0.2,7,14,0.5,4,6,0.667,1,13,14,0,2,6,1,8,21
2021,Chicago Sky,Playoffs,9,Dana Evans,22,9,0,64,5,16,0.313,5,12,0.417,0,4,0,0,0,,0,5,5,2,2,0,6,6,15
2021,Chicago Sky,Playoffs,10,Lexie Brown,26,7,0,24,2,6,0.333,2,5,0.4,0,1,0,2,2,1,0,2,2,1,0,0,0,0,8
2021,Chicago Sky,Playoffs,11,Ruthy Hebard,23,5,0,15,2,2,1,0,0,,2,2,1,0,0,,0,1,1,0,0,0,0,3,4
2021,Dallas Wings,Regular Season,1,Arike Ogunbowale,24,32,32,1003,199,520,0.383,80,213,0.376,119,307,0.388,121,140,0.864,23,80,103,104,36,0,68,72,599
2021,Dallas Wings,Regular Season,2,Kayla Thornton,28,31,25,857,83,197,0.421,22,63,0.349,61,134,0.455,45,53,0.849,65,108,173,45,26,7,30,62,233
2021,Dallas Wings,Regular Season,3,Marina Mabrey,24,32,8,773,158,390,0.405,63,184,0.342,95,206,0.461,45,51,0.882,23,101,124,93,32,10,68,79,424
2021,Dallas Wings,Regular Season,4,Allisha Gray,26,25,16,694,106,242,0.438,30,82,0.366,76,160,0.475,56,65,0.862,33,97,130,42,25,21,34,53,298
2021,Dallas Wings,Regular Season,5,Isabelle Harrison,27,28,5,665,129,240,0.538,0,1,0,129,239,0.54,47,60,0.783,44,121,165,31,31,19,42,69,305
2021,Dallas Wings,Regular Season,6,Tyasha Harris,23,32,3,522,48,143,0.336,20,59,0.339,28,84,0.333,25,30,0.833,9,42,51,85,13,10,32,40,141
2021,Dallas Wings,Regular Season,7,Moriah Jefferson,27,29,28,500,66,147,0.449,23,50,0.46,43,97,0.443,3,5,0.6,12,46,58,72,24,5,40,40,158
2021,Dallas Wings,Regular Season,8,Satou Sabally,23,17,14,423,69,165,0.418,18,55,0.327,51,110,0.464,47,61,0.77,27,73,100,48,4,14,39,54,203
2021,Dallas Wings,Regular Season,9,Bella Alarie,23,31,11,407,32,64,0.5,0,2,0,32,62,0.516,17,20,0.85,42,60,102,16,18,20,18,42,81
2021,Dallas Wings,Regular Season,10,Charli Collier,21,28,18,345,40,86,0.465,0,0,,40,86,0.465,16,23,0.696,31,71,102,6,4,5,13,51,96
2021,Dallas Wings,Regular Season,11,Awak Kuier,19,16,0,142,12,39,0.308,3,18,0.167,9,21,0.429,11,14,0.786,9,30,39,9,5,12,16,10,38
2021,Dallas Wings,Regular Season,12,Chelsea Dungee,24,14,0,64,3,17,0.176,2,10,0.2,1,7,0.143,0,0,,1,2,3,1,0,1,2,7,8
2021,Dallas Wings,Regular Season,13,Kristine Anigwe,24,3,0,30,3,6,0.5,0,0,,3,6,0.5,1,2,0.5,1,5,6,0,1,0,2,7,7
2021,Dallas Wings,Regular Season,14,Dana Evans,22,6,0,24,1,6,0.167,1,3,0.333,0,3,0,2,2,1,0,0,0,3,0,0,4,3,5
2021,Dallas Wings,Playoffs,1,Arike Ogunbowale,24,1,1,35,8,16,0.5,5,10,0.5,3,6,0.5,1,2,0.5,0,2,2,2,1,0,1,6,22
2021,Dallas Wings,Playoffs,2,Allisha Gray,26,1,1,34,3,5,0.6,1,1,1,2,4,0.5,2,2,1,1,5,6,2,1,1,1,3,9
2021,Dallas Wings,Playoffs,3,Isabelle Harrison,27,1,0,29,4,13,0.308,0,0,,4,13,0.308,1,2,0.5,2,8,10,1,0,0,1,3,9
2021,Dallas Wings,Playoffs,4,Moriah Jefferson,27,1,1,25,4,7,0.571,1,3,0.333,3,4,0.75,0,0,,0,2,2,4,2,0,4,1,9
2021,Dallas Wings,Playoffs,5,Satou Sabally,23,1,0,22,5,10,0.5,0,0,,5,10,0.5,2,3,0.667,2,2,4,1,2,1,2,3,12
2021,Dallas Wings,Playoffs,6,Marina Mabrey,24,1,0,17,1,8,0.125,1,4,0.25,0,4,0,0,0,,0,3,3,2,0,0,0,1,3
2021,Dallas Wings,Playoffs,7,Kayla Thornton,28,1,1,16,0,6,0,0,2,0,0,4,0,0,0,,0,2,2,0,0,0,0,1,0
2021,Dallas Wings,Playoffs,8,Awak Kuier,19,1,0,8,0,1,0,0,1,0,0,0,,0,0,,1,2,3,0,0,0,1,0,0
2021,Dallas Wings,Playoffs,9,Tyasha Harris,23,1,0,7,0,3,0,0,1,0,0,2,0,0,0,,0,0,0,1,0,0,0,0,0
2021,Dallas Wings,Playoffs,10,Bella Alarie,23,1,1,4,0,0,,0,0,,0,0,,0,0,,3,0,3,1,0,0,1,0,0
2021,Dallas Wings,Playoffs,11,Chelsea Dungee,24,1,0,1,0,0,,0,0,,0,0,,0,0,,0,0,0,0,0,0,0,0,0
2021,Los Angeles Sparks,Regular Season,1,Erica Wheeler,30,32,32,967,160,384,0.417,33,92,0.359,127,292,0.435,81,98,0.827,16,82,98,152,43,8,87,86,434
2021,Los Angeles Sparks,Regular Season,2,Brittney Sykes,27,32,20,939,115,284,0.405,11,42,0.262,104,242,0.43,61,79,0.772,37,109,146,70,58,15,45,79,302
2021,Los Angeles Sparks,Regular Season,3,Nia Coffey,26,32,17,805,93,221,0.421,50,120,0.417,43,101,0.426,28,36,0.778,18,104,122,28,26,38,45,85,264
2021,Los Angeles Sparks,Regular Season,4,Amanda Zahui B.,27,30,27,714,106,247,0.429,30,107,0.28,76,140,0.543,33,43,0.767,24,130,154,29,18,35,54,99,275
2021,Los Angeles Sparks,Regular Season,5,Te'a Cooper,24,31,13,682,97,256,0.379,24,74,0.324,73,182,0.401,63,84,0.75,4,50,54,44,28,6,57,69,281
2021,Los Angeles Sparks,Regular Season,6,Nneka Ogwumike,30,18,18,570,109,205,0.532,11,30,0.367,98,175,0.56,32,40,0.8,26,91,117,48,26,5,39,32,261
2021,Los Angeles Sparks,Regular Season,7,Kristi Toliver,34,19,19,525,67,162,0.414,28,83,0.337,39,79,0.494,16,19,0.842,9,19,28,54,14,0,32,36,178
2021,Los Angeles Sparks,Regular Season,8,Bria Holmes,27,17,5,312,31,95,0.326,8,33,0.242,23,62,0.371,13,23,0.565,20,27,47,20,15,6,20,21,83
2021,Los Angeles Sparks,Regular Season,9,Arella Guirantes,23,25,2,291,26,95,0.274,6,27,0.222,20,68,0.294,21,26,0.808,6,27,33,15,8,4,12,26,79
2021,Los Angeles Sparks,Regular Season,10,Lauren Cox,23,15,0,210,19,46,0.413,1,5,0.2,18,41,0.439,14,18,0.778,11,44,55,9,10,13,9,20,53
2021,Los Angeles Sparks,Regular Season,11,Karlie Samuelson,26,11,3,174,13,34,0.382,11,23,0.478,2,11,0.182,5,7,0.714,3,22,25,9,7,0,5,20,42
2021,Los Angeles Sparks,Regular Season,12,Chiney Ogwumike,29,7,3,134,20,49,0.408,3,4,0.75,17,45,0.378,6,8,0.75,11,18,29,9,6,3,6,23,49
2021,Los Angeles Sparks,Regular Season,13,Kristine Anigwe,24,7,1,106,9,23,0.391,0,0,,9,23,0.391,9,16,0.563,10,17,27,5,4,1,10,21,27
2021,Los Angeles Sparks,Regular Season,14,Jasmine Walker,23,2,0,20,0,5,0,0,4,0,0,1,0,0,2,0,0,1,1,2,2,1,1,1,0
2021,New York Liberty,Regular Season,1,Betnijah Laney,27,32,32,1069,203,450,0.451,34,109,0.312,169,341,0.496,96,122,0.787,27,105,132,167,21,3,119,70,536
2021,New York Liberty,Regular Season,2,Sabrina Ionescu,23,30,26,899,113,298,0.379,54,166,0.325,59,132,0.447,72,79,0.911,21,149,170,183,18,16,96,54,352
2021,New York Liberty,Regular Season,3,Sami Whitcomb,32,30,28,843,124,262,0.473,76,179,0.425,48,83,0.578,27,33,0.818,10,141,151,81,31,10,62,53,351
2021,New York Liberty,Regular Season,4,Michaela Onyenwere,21,32,29,711,91,227,0.401,37,113,0.327,54,114,0.474,56,67,0.836,21,73,94,18,14,9,34,80,275
2021,New York Liberty,Regular Season,5,Rebecca Allen,28,25,13,615,74,216,0.343,48,126,0.381,26,90,0.289,33,37,0.892,19,73,92,28,40,31,21,54,229
2021,New York Liberty,Regular Season,6,Kylee Shook,23,30,19,567,71,152,0.467,24,61,0.393,47,91,0.516,4,5,0.8,20,101,121,41,10,15,38,47,170
2021,New York Liberty,Regular Season,7,Jazmine Jones,24,27,0,448,53,149,0.356,18,47,0.383,35,102,0.343,35,46,0.761,12,54,66,31,14,10,43,64,159
2021,New York Liberty,Regular Season,8,Natasha Howard,29,13,13,357,87,176,0.494,12,36,0.333,75,140,0.536,24,31,0.774,28,66,94,22,17,7,49,38,210
2021,New York Liberty,Regular Season,9,DiDi Richards,22,31,0,346,27,64,0.422,10,22,0.455,17,42,0.405,6,10,0.6,9,25,34,25,17,6,16,24,70
2021,New York Liberty,Regular Season,10,Leaonna Odom,23,18,0,217,21,45,0.467,5,17,0.294,16,28,0.571,9,12,0.75,11,10,21,8,5,5,10,25,56
2021,New York Liberty,Regular Season,11,Reshanda Gray,28,15,0,210,34,64,0.531,2,9,0.222,32,55,0.582,18,26,0.692,13,40,53,5,4,4,21,47,88
2021,New York Liberty,Regular Season,12,Kiah Stokes,28,9,0,135,6,11,0.545,1,2,0.5,5,9,0.556,2,2,1,8,30,38,5,4,6,6,14,15
2021,New York Liberty,Regular Season,13,Joyner Holmes,23,1,0,5,0,0,,0,0,,0,0,,0,0,,0,0,0,1,0,0,1,1,0
2021,New York Liberty,Regular Season,14,Layshia Clarendon,30,1,0,3,0,0,,0,0,,0,0,,0,0,,0,0,0,0,0,0,2,1,0
2021,New York Liberty,Playoffs,1,Betnijah Laney,27,1,1,37,10,22,0.455,3,7,0.429,7,15,0.467,2,3,0.667,2,2,4,3,1,0,2,5,25
2021,New York Liberty,Playoffs,2,Sabrina Ionescu,23,1,1,35,5,12,0.417,1,7,0.143,4,5,0.8,3,3,1,0,5,5,11,1,0,2,1,14
2021,New York Liberty,Playoffs,3,Sami Whitcomb,32,1,1,34,1,4,0.25,1,3,0.333,0,1,0,0,0,,0,5,5,3,0,0,0,3,3
2021,New York Liberty,Playoffs,4,Natasha Howard,29,1,1,31,7,16,0.438,2,4,0.5,5,12,0.417,0,0,,3,7,10,2,1,1,3,3,16
2021,New York Liberty,Playoffs,5,Rebecca Allen,28,1,1,29,4,8,0.5,3,5,0.6,1,3,0.333,0,0,,0,4,4,0,1,3,0,3,11
2021,New York Liberty,Playoffs,6,DiDi Richards,22,1,0,12,2,2,1,1,1,1,1,1,1,0,0,,0,1,1,0,0,0,0,3,5
2021,New York Liberty,Playoffs,7,Reshanda Gray,28,1,0,9,3,3,1,1,1,1,2,2,1,1,1,1,1,1,2,1,1,0,2,4,8
2021,New York Liberty,Playoffs,8,Michaela Onyenwere,21,1,0,9,0,1,0,0,0,,0,1,0,0,0,,0,0,0,0,0,0,0,0,0
2021,New York Liberty,Playoffs,9,Jazmine Jones,24,1,0,3,0,1,0,0,0,,0,1,0,0,0,,0,0,0,0,0,0,0,0,0
2021,Washington Mystics,Regular Season,1,Ariel Atkins,24,30,30,918,161,396,0.407,66,184,0.359,95,212,0.448,98,118,0.831,34,49,83,79,48,16,61,96,486
2021,Washington Mystics,Regular Season,2,Tina Charles,32,27,27,900,238,530,0.449,50,137,0.365,188,393,0.478,105,128,0.82,73,185,258,57,25,23,59,63,631
2021,Washington Mystics,Regular Season,3,Natasha Cloud,29,27,27,852,81,208,0.389,26,95,0.274,55,113,0.487,46,55,0.836,11,87,98,174,37,4,59,62,234
2021,Washington Mystics,Regular Season,4,Leilani Mitchell,36,31,12,725,64,178,0.36,50,140,0.357,14,38,0.368,19,23,0.826,11,50,61,77,15,2,35,46,197
2021,Washington Mystics,Regular Season,5,Sydney Wiese,26,27,8,578,41,127,0.323,23,79,0.291,18,48,0.375,14,18,0.778,5,31,36,43,10,0,27,20,119
2021,Washington Mystics,Regular Season,6,Theresa Plaisance,29,31,11,559,71,202,0.351,35,116,0.302,36,86,0.419,22,27,0.815,21,114,135,42,25,21,37,68,199
2021,Washington Mystics,Regular Season,7,Myisha Hines-Allen,25,18,17,462,89,215,0.414,13,41,0.317,76,174,0.437,41,56,0.732,32,94,126,45,24,11,32,45,232
2021,Washington Mystics,Regular Season,8,Shavonte Zellous,34,28,5,442,43,114,0.377,10,41,0.244,33,73,0.452,25,31,0.806,16,50,66,44,11,6,23,48,121
2021,Washington Mystics,Regular Season,9,Erica McCall,25,23,6,356,37,74,0.5,0,1,0,37,73,0.507,20,32,0.625,33,66,99,13,7,9,20,46,94
2021,Washington Mystics,Regular Season,10,Shatori Walker-Kimbrough,26,16,13,346,40,78,0.513,8,25,0.32,32,53,0.604,30,35,0.857,4,19,23,16,12,4,19,27,118
2021,Washington Mystics,Regular Season,11,Megan Gustafson,24,11,1,109,19,32,0.594,0,2,0,19,30,0.633,6,9,0.667,11,29,40,0,2,1,9,10,44
2021,Washington Mystics,Regular Season,12,Kiara Leslie,25,9,0,86,8,24,0.333,2,7,0.286,6,17,0.353,7,8,0.875,2,18,20,2,4,0,4,11,25
2021,Washington Mystics,Regular Season,13,Elena Delle Donne,31,3,3,52,13,27,0.481,3,5,0.6,10,22,0.455,12,12,1,3,10,13,2,0,1,2,2,41
2021,Washington Mystics,Regular Season,14,Stella Johnson,22,6,0,31,3,8,0.375,2,5,0.4,1,3,0.333,4,4,1,3,0,3,2,0,1,5,7,12
2021,Washington Mystics,Regular Season,15,Jillian Alleyne,26,2,0,8,0,2,0,0,0,,0,2,0,0,0,,1,3,4,0,1,0,0,0,0
2021,Atlanta Dream,Regular Season,1,Courtney Williams,27,32,32,1101,228,546,0.418,39,102,0.382,189,444,0.426,34,53,0.642,46,172,218,128,34,16,58,53,529
2021,Atlanta Dream,Regular Season,2,Elizabeth Williams,28,32,32,761,80,155,0.516,0,0,,80,155,0.516,27,53,0.509,63,94,157,38,36,43,25,60,187
2021,Atlanta Dream,Regular Season,3,Odyssey Sims,28,30,21,753,105,284,0.37,16,69,0.232,89,215,0.414,35,48,0.729,15,60,75,108,37,2,49,45,261
2021,Atlanta Dream,Regular Season,4,Monique Billings,25,31,9,740,100,202,0.495,0,2,0,100,200,0.5,52,77,0.675,88,112,200,32,37,32,43,79,252
2021,Atlanta Dream,Regular Season,5,Tiffany Hayes,31,21,19,595,105,240,0.438,34,84,0.405,71,156,0.455,64,75,0.853,14,53,67,63,33,4,31,65,308
2021,Atlanta Dream,Regular Season,6,Aari McDonald,22,30,4,493,56,174,0.322,32,104,0.308,24,70,0.343,45,51,0.882,9,40,49,59,25,5,35,53,189
2021,Atlanta Dream,Regular Season,7,Crystal Bradford,27,24,9,440,82,191,0.429,29,81,0.358,53,110,0.482,18,39,0.462,31,60,91,36,28,9,23,56,211
2021,Atlanta Dream,Regular Season,8,Tianna Hawkins,30,28,8,433,50,126,0.397,16,66,0.242,34,60,0.567,21,23,0.913,14,73,87,17,11,14,32,62,137
2021,Atlanta Dream,Regular Season,9,Chennedy Carter,22,11,11,280,60,132,0.455,1,9,0.111,59,123,0.48,35,40,0.875,5,9,14,36,8,4,23,33,156
2021,Atlanta Dream,Regular Season,10,Cheyenne Parker,28,13,11,270,50,110,0.455,10,30,0.333,40,80,0.5,22,28,0.786,13,45,58,16,15,12,17,28,132
2021,Atlanta Dream,Regular Season,11,Shekinna Stricklen,30,24,0,236,22,85,0.259,14,66,0.212,8,19,0.421,2,5,0.4,2,20,22,8,10,4,3,26,60
2021,Atlanta Dream,Regular Season,12,Candice Dupree,36,10,4,203,33,76,0.434,0,3,0,33,73,0.452,7,11,0.636,7,31,38,6,5,2,9,8,73
2021,Atlanta Dream,Regular Season,13,Blake Dietrick,27,9,0,141,8,27,0.296,5,16,0.313,3,11,0.273,0,0,,3,11,14,11,5,1,5,20,21
2021,Atlanta Dream,Regular Season,14,Kalani Brown,24,1,0,5,1,3,0.333,0,0,,1,3,0.333,0,0,,0,1,1,0,0,0,0,0,2
2021,Indiana Fever,Regular Season,1,Kelsey Mitchell,25,32,32,1059,212,492,0.431,70,209,0.335,142,283,0.502,75,85,0.882,21,63,84,80,34,7,65,74,569
2021,Indiana Fever,Regular Season,2,Teaira McCowan,24,32,23,848,138,257,0.537,0,0,,138,257,0.537,85,132,0.644,109,199,308,34,18,51,53,107,361
2021,Indiana Fever,Regular Season,3,Tiffany Mitchell,26,28,25,765,107,254,0.421,12,47,0.255,95,207,0.459,110,125,0.88,25,55,80,56,17,1,54,53,336
2021,Indiana Fever,Regular Season,4,Victoria Vivians,26,31,8,661,77,231,0.333,32,127,0.252,45,104,0.433,25,30,0.833,14,81,95,40,35,4,41,57,211
2021,Indiana Fever,Regular Season,5,Danielle Robinson,32,24,24,659,88,211,0.417,5,25,0.2,83,186,0.446,56,63,0.889,8,77,85,89,38,2,42,50,237
2021,Indiana Fever,Regular Season,6,Lindsay Allen,26,32,8,571,65,152,0.428,14,47,0.298,51,105,0.486,30,37,0.811,9,39,48,96,17,3,31,34,174
2021,Indiana Fever,Regular Season,7,Jessica Breland,33,26,18,544,67,180,0.372,5,16,0.313,62,164,0.378,13,19,0.684,37,126,163,53,16,39,48,51,152
2021,Indiana Fever,Regular Season,8,Jantel Lavender,32,27,14,539,76,188,0.404,4,20,0.2,72,168,0.429,18,20,0.9,46,59,105,41,0,4,37,48,174
2021,Indiana Fever,Regular Season,9,Emma Cannon,32,12,6,220,35,79,0.443,3,14,0.214,32,65,0.492,10,14,0.714,18,36,54,12,5,2,24,29,83
2021,Indiana Fever,Regular Season,10,Kysre Gondrezick,23,19,0,173,13,46,0.283,8,28,0.286,5,18,0.278,2,4,0.5,3,16,19,18,7,0,17,14,36
2021,Indiana Fever,Regular Season,11,Aaliyah Wilson,22,14,0,119,6,26,0.231,1,7,0.143,5,19,0.263,2,4,0.5,5,7,12,8,3,2,9,17,15
2021,Indiana Fever,Regular Season,12,Bernadett Hatar,26,7,2,106,14,29,0.483,0,0,,14,29,0.483,6,7,0.857,7,11,18,2,3,3,11,18,34
2021,Indiana Fever,Regular Season,13,Lauren Cox,23,11,0,95,6,19,0.316,1,3,0.333,5,16,0.313,2,2,1,5,17,22,3,4,3,7,9,15
2021,Indiana Fever,Regular Season,14,Chelsey Perry,22,6,0,40,5,18,0.278,2,9,0.222,3,9,0.333,1,2,0.5,0,6,6,2,3,0,2,7,13
2020,Seattle Storm,Regular Season,1,Breanna Stewart,25,20,20,30.4,6.7,14.8,0.451,1.8,4.8,0.368,4.9,10,0.49,4.7,5.2,0.894,1,7.3,8.3,3.6,1.7,1.3,2.6,2.3,19.7
2020,Seattle Storm,Regular Season,2,Alysha Clark,32,22,22,28.8,3.7,6.7,0.558,1.6,3,0.522,2.1,3.6,0.588,0.9,1.1,0.8,0.9,3.4,4.2,2.7,1.5,0.5,0.9,1.7,10
2020,Seattle Storm,Regular Season,3,Jewell Loyd,26,22,22,27.9,5.1,11.5,0.443,1.8,4.5,0.39,3.3,7,0.477,3.5,4,0.875,0.6,1.7,2.4,3.2,1.5,0.3,1.9,1.5,15.5
2020,Seattle Storm,Regular Season,4,Jordin Canada,24,20,11,24.2,2.8,6.6,0.424,0.1,0.6,0.091,2.8,6.1,0.455,2.2,2.9,0.772,0.5,1.8,2.3,5.5,1.5,0,2,1.8,7.9
2020,Seattle Storm,Regular Season,5,Sue Bird,39,11,11,23.4,3.7,7.5,0.494,2.1,4.5,0.469,1.6,3.1,0.529,0.3,0.4,0.75,0.1,1.6,1.7,5.2,0.6,0.2,1.6,0.8,9.8
2020,Seattle Storm,Regular Season,6,Natasha Howard,28,22,22,21,4,7.5,0.53,0.3,0.9,0.35,3.6,6.5,0.556,1.3,1.6,0.778,2.4,4.7,7.1,1,1.7,0.6,2.1,3,9.5
2020,Seattle Storm,Regular Season,7,Sami Whitcomb,31,22,0,16.5,2.8,6.4,0.443,1.5,3.8,0.381,1.4,2.5,0.536,1,1,1,0.2,2.1,2.3,2,0.7,0.1,1,1.4,8.1
2020,Seattle Storm,Regular Season,8,Mercedes Russell,24,22,2,13.8,1.5,3.5,0.41,0,0,,1.5,3.5,0.41,0.6,1.1,0.56,0.7,2.5,3.2,0.6,0.4,0.4,0.7,1,3.5
2020,Seattle Storm,Regular Season,9,Ezi Magbegor,20,22,0,13.3,2.8,5,0.569,0,0.1,0.333,2.8,4.8,0.575,0.9,1.2,0.704,1.1,1.3,2.5,0.3,0.5,0.7,0.4,2,6.5
2020,Seattle Storm,Regular Season,10,Epiphanny Prince,32,15,0,12.7,1.5,3.8,0.386,0.6,1.8,0.333,0.9,2,0.433,0.7,0.9,0.846,0.1,1.1,1.2,1.4,0.4,0.1,0.8,1.5,4.3
2020,Seattle Storm,Regular Season,11,Morgan Tuck,26,10,0,8.8,0.5,1.6,0.313,0.2,0.9,0.222,0.3,0.7,0.429,0.5,0.8,0.625,0.2,0.4,0.6,0.2,0.5,0,0.6,1.2,1.7
2020,Seattle Storm,Regular Season,12,Crystal Langhorne,33,13,0,8.2,0.5,1.3,0.412,0.1,0.4,0.2,0.5,0.9,0.5,0.2,0.5,0.5,0.2,1.9,2.2,0.5,0.1,0.1,0.8,0.5,1.4
2020,Seattle Storm,Playoffs,1,Breanna Stewart,25,6,6,32.7,9.5,17.7,0.538,2.8,5.7,0.5,6.7,12,0.556,3.8,4.5,0.852,1,6.8,7.8,4,1.7,1.7,1.2,1.8,25.7
2020,Seattle Storm,Playoffs,2,Alysha Clark,32,6,6,30.5,4,8.8,0.453,1.3,3.8,0.348,2.7,5,0.533,1,1,1,1.8,4.7,6.5,3.2,0.7,0.7,0.7,2.7,10.3
2020,Seattle Storm,Playoffs,3,Jewell Loyd,26,6,6,30.2,6.8,12.3,0.554,1.8,4.7,0.393,5,7.7,0.652,2.3,2.5,0.933,1.2,3.8,5,3.8,1.3,0.5,2.3,2,17.8
2020,Seattle Storm,Playoffs,4,Sue Bird,39,6,6,26.5,3.3,8.5,0.392,2,6.3,0.316,1.3,2.2,0.615,0.8,0.8,1,0,2,2,9.2,0.7,0.3,2.3,1.8,9.5
2020,Seattle Storm,Playoffs,5,Natasha Howard,28,6,6,23,3.8,7,0.548,0.5,1,0.5,3.3,6,0.556,1.3,1.8,0.727,1.2,4.2,5.3,1.5,1.2,0.8,1.5,3,9.5
2020,Seattle Storm,Playoffs,6,Mercedes Russell,24,6,0,17.5,2.2,3.5,0.619,0,0,,2.2,3.5,0.619,0.8,0.8,1,1.2,2.7,3.8,1,0.2,0.2,0.8,2.8,5.2
2020,Seattle Storm,Playoffs,7,Jordin Canada,24,6,0,15.5,3,5.5,0.545,0,0.5,0,3,5,0.6,1,1.5,0.667,0.5,1.3,1.8,1.3,0.5,0,0.3,0.8,7
2020,Seattle Storm,Playoffs,8,Epiphanny Prince,32,5,0,13,1.6,3.4,0.471,0.8,2.2,0.364,0.8,1.2,0.667,1,1.2,0.833,0,0.8,0.8,2.2,1,0,0.4,0.8,5
2020,Seattle Storm,Playoffs,9,Sami Whitcomb,31,3,0,10.7,2,6,0.333,1,3.7,0.273,1,2.3,0.429,0,0,,0,1.3,1.3,1.7,1,0,0.3,1,5
2020,Seattle Storm,Playoffs,10,Morgan Tuck,26,1,0,7,1,5,0.2,0,2,0,1,3,0.333,0,0,,0,1,1,1,0,0,0,1,2
2020,Seattle Storm,Playoffs,11,Crystal Langhorne,33,1,0,6,0,2,0,0,2,0,0,0,,0,0,,0,2,2,1,0,0,0,1,0
2020,Seattle Storm,Playoffs,12,Ezi Magbegor,20,6,0,5.8,0.3,1.5,0.222,0,0.3,0,0.3,1.2,0.286,0.3,0.3,1,0,1.2,1.2,0.3,0,0.2,0,0.7,1
2020,Las Vegas Aces,Regular Season,1,A'ja Wilson,23,22,22,697,166,346,0.48,0,0,,166,346,0.48,118,151,0.781,34,154,188,45,27,44,35,49,450
2020,Las Vegas Aces,Regular Season,2,Dearica Hamby,26,22,0,622,110,204,0.539,18,38,0.474,92,166,0.554,48,67,0.716,28,129,157,60,37,4,45,50,286
2020,Las Vegas Aces,Regular Season,3,Kayla McBride,28,22,22,587,90,212,0.425,25,73,0.342,65,139,0.468,70,78,0.897,9,42,51,52,26,2,31,30,275
2020,Las Vegas Aces,Regular Season,4,Jackie Young,22,22,0,568,93,189,0.492,3,13,0.231,90,176,0.511,52,61,0.852,18,77,95,67,15,2,35,39,241
2020,Las Vegas Aces,Regular Season,5,Danielle Robinson,31,22,1,492,62,121,0.512,5,13,0.385,57,108,0.528,34,42,0.81,5,48,53,71,19,2,28,38,163
2020,Las Vegas Aces,Regular Season,6,Angel McCoughtry,33,22,22,440,117,226,0.518,16,34,0.471,101,192,0.526,67,76,0.882,37,75,112,54,29,6,38,49,317
2020,Las Vegas Aces,Regular Season,7,Carolyn Swords,30,22,21,384,23,50,0.46,0,0,,23,50,0.46,17,22,0.773,33,69,102,20,5,1,18,21,63
2020,Las Vegas Aces,Regular Season,8,Lindsay Allen,25,21,21,284,28,66,0.424,6,17,0.353,22,49,0.449,8,10,0.8,6,17,23,51,7,1,16,20,70
2020,Las Vegas Aces,Regular Season,9,Sugar Rodgers,30,22,1,263,26,81,0.321,20,64,0.313,6,17,0.353,3,4,0.75,3,25,28,31,7,3,16,25,75
2020,Las Vegas Aces,Regular Season,10,Cierra Burdick,26,13,0,28,2,7,0.286,0,0,,2,7,0.286,0,0,,1,4,5,2,0,0,1,2,4
2020,Las Vegas Aces,Regular Season,11,Avery Warley-Talbert,33,3,0,24,3,7,0.429,0,0,,3,7,0.429,2,3,0.667,5,3,8,3,0,0,2,6,8
2020,Las Vegas Aces,Regular Season,12,Megan Huff,24,4,0,11,0,2,0,0,1,0,0,1,0,0,0,,0,1,1,0,0,0,3,2,0
2020,Las Vegas Aces,Regular Season,13,Emma Cannon,31,1,0,0,0,0,,0,0,,0,0,,0,0,,0,0,0,0,0,0,0,0,0
2020,Las Vegas Aces,Playoffs,1,A'ja Wilson,23,8,8,283,62,131,0.473,0,0,,62,131,0.473,42,49,0.857,17,54,71,19,8,18,16,14,166
2020,Las Vegas Aces,Playoffs,2,Kayla McBride,28,8,8,247,28,70,0.4,10,29,0.345,18,41,0.439,10,10,1,1,26,27,23,4,1,11,11,76
2020,Las Vegas Aces,Playoffs,3,Danielle Robinson,31,8,7,239,27,68,0.397,3,9,0.333,24,59,0.407,16,22,0.727,8,27,35,31,10,0,12,9,73
2020,Las Vegas Aces,Playoffs,4,Angel McCoughtry,33,8,8,201,45,109,0.413,11,20,0.55,34,89,0.382,23,27,0.852,10,29,39,22,13,2,15,24,124
2020,Las Vegas Aces,Playoffs,5,Carolyn Swords,30,8,8,177,13,27,0.481,0,0,,13,27,0.481,0,0,,19,29,48,10,3,5,5,16,26
2020,Las Vegas Aces,Playoffs,6,Jackie Young,22,8,0,163,21,68,0.309,1,6,0.167,20,62,0.323,19,21,0.905,3,21,24,22,2,1,19,18,62
2020,Las Vegas Aces,Playoffs,7,Emma Cannon,31,6,0,86,11,22,0.5,1,5,0.2,10,17,0.588,0,2,0,6,7,13,5,0,0,10,19,23
2020,Las Vegas Aces,Playoffs,8,Sugar Rodgers,30,8,0,79,3,21,0.143,3,18,0.167,0,3,0,0,0,,1,8,9,8,2,0,5,9,9
2020,Las Vegas Aces,Playoffs,9,Dearica Hamby,26,3,0,75,9,17,0.529,1,5,0.2,8,12,0.667,5,8,0.625,2,7,9,7,2,0,8,8,24
2020,Las Vegas Aces,Playoffs,10,Lindsay Allen,25,5,1,32,3,9,0.333,0,3,0,3,6,0.5,0,0,,0,1,1,2,1,1,6,3,6
2020,Las Vegas Aces,Playoffs,11,Cierra Burdick,26,4,0,19,2,7,0.286,0,0,,2,7,0.286,0,0,,0,4,4,2,0,0,0,1,4
2020,Los Angeles Sparks,Regular Season,1,Chelsea Gray,27,22,22,679,122,276,0.442,18,59,0.305,104,217,0.479,46,49,0.939,15,66,81,116,34,2,60,38,308
2020,Los Angeles Sparks,Regular Season,2,Candace Parker,34,22,22,665,124,243,0.51,19,48,0.396,105,195,0.538,57,78,0.731,37,177,214,101,26,27,64,51,324
2020,Los Angeles Sparks,Regular Season,3,Brittney Sykes,26,21,14,517,73,150,0.487,16,49,0.327,57,101,0.564,50,62,0.806,16,38,54,45,31,6,36,62,212
2020,Los Angeles Sparks,Regular Season,4,Nneka Ogwumike,29,18,18,476,95,167,0.569,9,18,0.5,86,149,0.577,41,49,0.837,21,66,87,31,19,3,28,41,240
2020,Los Angeles Sparks,Regular Season,5,Riquna Williams,30,21,4,444,81,186,0.435,43,102,0.422,38,84,0.452,16,18,0.889,3,35,38,31,24,7,19,41,221
2020,Los Angeles Sparks,Regular Season,6,Sydney Wiese,25,19,15,363,47,93,0.505,25,53,0.472,22,40,0.55,11,12,0.917,5,28,33,22,11,2,22,17,130
2020,Los Angeles Sparks,Regular Season,7,Te'a Cooper,23,20,3,345,51,113,0.451,11,32,0.344,40,81,0.494,26,34,0.765,2,18,20,40,13,0,29,39,139
2020,Los Angeles Sparks,Regular Season,8,Seimone Augustus,36,21,0,332,54,110,0.491,12,22,0.545,42,88,0.477,4,6,0.667,3,34,37,25,12,2,8,20,124
2020,Los Angeles Sparks,Regular Season,9,Tierra Ruffin-Pratt,29,17,10,251,12,45,0.267,6,13,0.462,6,32,0.188,19,26,0.731,9,27,36,15,11,3,9,28,49
2020,Los Angeles Sparks,Regular Season,10,Kristine Anigwe,23,17,1,197,32,53,0.604,0,0,,32,53,0.604,14,26,0.538,18,27,45,4,11,7,16,33,78
2020,Los Angeles Sparks,Regular Season,11,Marie Gulich,26,12,1,119,13,26,0.5,0,3,0,13,23,0.565,3,3,1,5,13,18,7,4,3,5,23,29
2020,Los Angeles Sparks,Regular Season,12,Reshanda Gray,27,10,0,62,4,11,0.364,0,0,,4,11,0.364,6,7,0.857,6,22,28,3,1,4,10,10,14
2020,Los Angeles Sparks,Playoffs,1,Candace Parker,34,1,1,40,6,13,0.462,1,2,0.5,5,11,0.455,9,10,0.9,1,13,14,5,1,2,1,2,22
2020,Los Angeles Sparks,Playoffs,2,Chelsea Gray,27,1,1,35,2,9,0.222,0,4,0,2,5,0.4,0,0,,0,2,2,0,1,0,3,3,4
2020,Los Angeles Sparks,Playoffs,3,Seimone Augustus,36,1,0,22,3,6,0.5,0,0,,3,6,0.5,4,4,1,2,1,3,1,0,1,1,0,10
2020,Los Angeles Sparks,Playoffs,4,Brittney Sykes,26,1,1,22,3,11,0.273,0,4,0,3,7,0.429,2,2,1,2,3,5,2,0,0,3,6,8
2020,Los Angeles Sparks,Playoffs,5,Te'a Cooper,23,1,0,21,1,4,0.25,1,2,0.5,0,2,0,0,0,,0,0,0,2,1,0,3,0,3
2020,Los Angeles Sparks,Playoffs,6,Kristine Anigwe,23,1,1,18,3,5,0.6,0,0,,3,5,0.6,2,2,1,2,5,7,0,0,1,1,2,8
2020,Los Angeles Sparks,Playoffs,7,Sydney Wiese,25,1,1,18,0,3,0,0,2,0,0,1,0,0,0,,0,0,0,1,0,0,0,0,0
2020,Los Angeles Sparks,Playoffs,8,Tierra Ruffin-Pratt,29,1,0,13,0,4,0,0,2,0,0,2,0,0,0,,0,2,2,3,0,1,1,2,0
2020,Los Angeles Sparks,Playoffs,9,Riquna Williams,30,1,0,10,1,4,0.25,0,2,0,1,2,0.5,0,0,,0,1,1,0,1,0,1,1,2
2020,Los Angeles Sparks,Playoffs,10,Reshanda Gray,27,1,0,1,1,1,1,0,0,,1,1,1,0,0,,0,1,1,0,1,0,0,0,2
2020,Minnesota Lynx,Regular Season,1,Napheesa Collier,23,22,22,752,136,260,0.523,20,49,0.408,116,211,0.55,63,76,0.829,61,138,199,73,40,28,60,60,355
2020,Minnesota Lynx,Regular Season,2,Crystal Dangerfield,22,21,19,629,124,263,0.471,34,102,0.333,90,161,0.559,59,64,0.922,5,36,41,75,18,1,54,31,341
2020,Minnesota Lynx,Regular Season,3,Damiris Dantas,27,22,22,586,102,220,0.464,39,90,0.433,63,130,0.485,40,55,0.727,37,97,134,58,25,5,40,56,283
2020,Minnesota Lynx,Regular Season,4,Bridget Carleton,23,22,15,568,53,102,0.52,21,46,0.457,32,56,0.571,18,28,0.643,22,57,79,54,15,0,27,40,145
2020,Minnesota Lynx,Regular Season,5,Lexie Brown,25,17,13,374,38,111,0.342,14,52,0.269,24,59,0.407,19,24,0.792,3,30,33,41,31,0,24,26,109
2020,Minnesota Lynx,Regular Season,6,Rachel Banham,26,20,1,339,48,104,0.462,25,53,0.472,23,51,0.451,16,20,0.8,2,23,25,47,9,2,20,40,137
2020,Minnesota Lynx,Regular Season,7,Odyssey Sims,27,13,7,240,42,104,0.404,8,24,0.333,34,80,0.425,30,33,0.909,8,18,26,45,7,1,25,22,122
2020,Minnesota Lynx,Regular Season,8,Mikiah Herbert Harrigan,21,21,0,234,30,82,0.366,14,33,0.424,16,49,0.327,5,7,0.714,14,34,48,7,8,9,15,21,79
2020,Minnesota Lynx,Regular Season,9,Shenise Johnson,29,17,4,212,28,82,0.341,6,17,0.353,22,65,0.338,25,28,0.893,10,23,33,21,16,1,20,18,87
2020,Minnesota Lynx,Regular Season,10,Erica McCall,24,19,0,178,16,45,0.356,1,4,0.25,15,41,0.366,18,22,0.818,23,24,47,3,6,7,9,23,51
2020,Minnesota Lynx,Regular Season,11,Sylvia Fowles,34,7,7,168,39,64,0.609,0,0,,39,64,0.609,24,29,0.828,21,47,68,6,6,8,8,18,102
2020,Minnesota Lynx,Regular Season,12,Kayla Alexander,29,16,0,89,16,30,0.533,0,0,,16,30,0.533,5,8,0.625,9,6,15,3,2,3,6,14,37
2020,Minnesota Lynx,Regular Season,13,Karima Christmas-Kelly,30,2,0,25,1,7,0.143,0,3,0,1,4,0.25,7,8,0.875,1,5,6,1,3,1,4,2,9
2020,Minnesota Lynx,Regular Season,14,Megan Huff,24,3,0,5,0,1,0,0,0,,0,1,0,0,0,,2,1,3,1,0,0,0,1,0
2020,Minnesota Lynx,Playoffs,1,Napheesa Collier,23,4,4,137,27,54,0.5,7,13,0.538,20,41,0.488,5,8,0.625,8,28,36,12,2,10,8,12,66
2020,Minnesota Lynx,Playoffs,2,Damiris Dantas,27,4,4,137,24,51,0.471,14,27,0.519,10,24,0.417,10,12,0.833,8,22,30,11,6,0,10,14,72
2020,Minnesota Lynx,Playoffs,3,Crystal Dangerfield,22,4,4,136,18,53,0.34,4,16,0.25,14,37,0.378,7,11,0.636,1,10,11,15,4,0,8,11,47
2020,Minnesota Lynx,Playoffs,4,Odyssey Sims,27,4,4,131,21,51,0.412,3,13,0.231,18,38,0.474,16,16,1,1,12,13,17,7,0,11,9,61
2020,Minnesota Lynx,Playoffs,5,Bridget Carleton,23,4,3,118,9,18,0.5,7,13,0.538,2,5,0.4,0,0,,5,10,15,10,5,0,3,5,25
2020,Minnesota Lynx,Playoffs,6,Rachel Banham,26,4,0,75,9,29,0.31,4,12,0.333,5,17,0.294,1,1,1,1,5,6,7,0,1,5,6,23
2020,Minnesota Lynx,Playoffs,7,Mikiah Herbert Harrigan,21,3,0,29,3,5,0.6,2,4,0.5,1,1,1,1,2,0.5,1,4,5,0,0,1,3,6,9
2020,Minnesota Lynx,Playoffs,8,Sylvia Fowles,34,1,1,18,2,8,0.25,0,0,,2,8,0.25,2,2,1,1,3,4,1,0,0,1,0,6
2020,Minnesota Lynx,Playoffs,9,Erica McCall,24,3,0,16,2,3,0.667,0,0,,2,3,0.667,3,3,1,2,4,6,0,0,1,0,2,7
2020,Minnesota Lynx,Playoffs,10,Shenise Johnson,29,1,0,3,0,1,0,0,0,,0,1,0,0,0,,0,0,0,0,0,0,0,0,0
2020,Chicago Sky,Regular Season,1,Courtney Vandersloot,31,22,22,693,107,218,0.491,30,76,0.395,77,142,0.542,56,63,0.889,11,66,77,220,26,8,54,46,300
2020,Chicago Sky,Regular Season,2,Kahleah Copper,25,22,22,688,132,266,0.496,21,61,0.344,111,205,0.541,42,57,0.737,21,99,120,47,21,5,54,52,327
2020,Chicago Sky,Regular Season,3,Allie Quigley,34,22,22,631,129,288,0.448,46,133,0.346,83,155,0.535,34,37,0.919,6,57,63,52,14,6,28,31,338
2020,Chicago Sky,Regular Season,4,Gabby Williams,23,22,4,546,67,158,0.424,20,70,0.286,47,88,0.534,16,25,0.64,20,68,88,44,29,5,37,32,170
2020,Chicago Sky,Regular Season,5,Cheyenne Parker,27,20,13,497,97,175,0.554,15,32,0.469,82,143,0.573,58,68,0.853,47,81,128,30,26,18,55,63,267
2020,Chicago Sky,Regular Season,6,Azura Stevens,24,13,13,355,59,118,0.5,15,39,0.385,44,79,0.557,17,20,0.85,18,59,77,20,12,24,20,39,150
2020,Chicago Sky,Regular Season,7,Ruthy Hebard,22,22,6,320,58,85,0.682,0,0,,58,85,0.682,9,12,0.75,18,68,86,7,10,8,15,35,125
2020,Chicago Sky,Regular Season,8,Stefanie Dolson,28,15,8,273,34,70,0.486,12,32,0.375,22,38,0.579,14,19,0.737,11,41,52,25,6,13,15,48,94
2020,Chicago Sky,Regular Season,9,Diamond DeShields,25,13,0,224,36,83,0.434,3,18,0.167,33,65,0.508,14,18,0.778,3,20,23,20,12,1,30,27,89
2020,Chicago Sky,Regular Season,10,Sydney Colson,30,17,0,110,10,22,0.455,3,9,0.333,7,13,0.538,7,8,0.875,1,6,7,14,6,0,14,13,30
2020,Chicago Sky,Regular Season,11,Stephanie Mavunga,25,5,0,36,5,11,0.455,0,3,0,5,8,0.625,0,0,,3,10,13,2,1,0,6,8,10
2020,Chicago Sky,Regular Season,12,Alexis Prince,26,2,0,16,3,5,0.6,2,3,0.667,1,2,0.5,0,0,,2,1,3,0,0,1,0,1,8
2020,Chicago Sky,Regular Season,13,Stella Johnson,21,4,0,6,0,1,0,0,0,,0,1,0,0,0,,0,2,2,0,1,0,0,1,0
2020,Chicago Sky,Regular Season,14,Alisia Jenkins,26,2,0,3,0,0,,0,0,,0,0,,0,0,,0,0,0,0,0,0,0,0,0
2020,Chicago Sky,Playoffs,1,Courtney Vandersloot,31,1,1,36,5,10,0.5,2,4,0.5,3,6,0.5,0,0,,1,3,4,6,2,0,2,4,12
2020,Chicago Sky,Playoffs,2,Kahleah Copper,25,1,1,35,7,14,0.5,2,4,0.5,5,10,0.5,1,4,0.25,0,0,0,4,2,0,2,2,17
2020,Chicago Sky,Playoffs,3,Gabby Williams,23,1,0,32,6,14,0.429,2,5,0.4,4,9,0.444,2,2,1,3,2,5,2,2,0,1,3,16
2020,Chicago Sky,Playoffs,4,Allie Quigley,34,1,1,28,7,9,0.778,1,3,0.333,6,6,1,4,4,1,0,0,0,0,0,0,1,1,19
2020,Chicago Sky,Playoffs,5,Cheyenne Parker,27,1,1,25,1,4,0.25,0,1,0,1,3,0.333,6,6,1,1,7,8,3,2,1,3,3,8
2020,Chicago Sky,Playoffs,6,Ruthy Hebard,22,1,1,18,2,4,0.5,0,0,,2,4,0.5,0,0,,0,2,2,0,0,1,2,2,4
2020,Chicago Sky,Playoffs,7,Stefanie Dolson,28,1,0,16,1,4,0.25,0,2,0,1,2,0.5,0,0,,0,2,2,3,0,1,0,2,2
2020,Chicago Sky,Playoffs,8,Alexis Prince,26,1,0,9,1,1,1,1,1,1,0,0,,0,0,,0,0,0,0,0,1,0,1,3
2020,Chicago Sky,Playoffs,9,Stephanie Mavunga,25,1,0,1,0,0,,0,0,,0,0,,0,0,,0,0,0,0,0,0,1,1,0
2020,Chicago Sky,Playoffs,10,Sydney Colson,30,1,0,0,0,0,,0,0,,0,0,,0,0,,0,0,0,0,0,0,0,0,0
2020,Phoenix Mercury,Regular Season,1,Skylar Diggins-Smith,29,22,22,675,127,268,0.474,46,116,0.397,81,152,0.533,90,100,0.9,11,62,73,93,20,11,70,50,390
2020,Phoenix Mercury,Regular Season,2,Brianna Turner,23,22,22,613,66,114,0.579,0,1,0,66,113,0.584,27,42,0.643,57,141,198,39,24,43,31,66,159
2020,Phoenix Mercury,Regular Season,3,Diana Taurasi,38,19,19,533,96,235,0.409,61,167,0.365,35,68,0.515,103,113,0.912,2,77,79,86,19,8,44,52,356
2020,Phoenix Mercury,Regular Season,4,Kia Vaughn,33,22,10,415,62,127,0.488,0,2,0,62,125,0.496,11,19,0.579,24,56,80,34,11,7,34,39,135
2020,Phoenix Mercury,Regular Season,5,Shatori Walker-Kimbrough,25,21,10,400,54,126,0.429,22,51,0.431,32,75,0.427,23,25,0.92,6,28,34,32,23,8,21,24,153
2020,Phoenix Mercury,Regular Season,6,Sophie Cunningham,23,21,11,396,35,91,0.385,12,51,0.235,23,40,0.575,22,25,0.88,9,13,22,16,11,3,15,46,104
2020,Phoenix Mercury,Regular Season,7,Brittney Griner,29,12,12,382,87,175,0.497,0,1,0,87,174,0.5,38,47,0.809,18,72,90,36,4,22,30,30,212
2020,Phoenix Mercury,Regular Season,8,Bria Hartley,27,13,3,322,66,157,0.42,25,65,0.385,41,92,0.446,33,41,0.805,5,33,38,58,15,0,27,33,190
2020,Phoenix Mercury,Regular Season,9,Alanna Smith,23,19,0,296,43,102,0.422,10,43,0.233,33,59,0.559,20,29,0.69,21,48,69,23,5,15,18,47,116
2020,Phoenix Mercury,Regular Season,10,Nia Coffey,25,15,1,230,16,38,0.421,7,21,0.333,9,17,0.529,1,6,0.167,5,32,37,12,5,5,7,30,40
2020,Phoenix Mercury,Regular Season,11,Shey Peddy,31,8,0,141,10,34,0.294,2,19,0.105,8,15,0.533,10,10,1,7,17,24,19,12,1,7,14,32
2020,Phoenix Mercury,Regular Season,12,Alisia Jenkins,26,2,0,23,2,8,0.25,0,3,0,2,5,0.4,4,6,0.667,0,3,3,0,0,0,3,3,8
2020,Phoenix Mercury,Playoffs,1,Brianna Turner,23,2,2,79,8,10,0.8,0,0,,8,10,0.8,1,4,0.25,4,21,25,8,2,4,5,4,17
2020,Phoenix Mercury,Playoffs,2,Skylar Diggins-Smith,29,2,2,73,10,33,0.303,3,13,0.231,7,20,0.35,9,10,0.9,1,9,10,11,1,0,7,6,32
2020,Phoenix Mercury,Playoffs,3,Diana Taurasi,38,2,2,70,16,34,0.471,10,21,0.476,6,13,0.462,9,9,1,1,7,8,15,1,0,4,6,51
2020,Phoenix Mercury,Playoffs,4,Kia Vaughn,33,2,2,63,11,23,0.478,0,1,0,11,22,0.5,0,0,,3,9,12,1,0,0,2,6,22
2020,Phoenix Mercury,Playoffs,5,Shey Peddy,31,2,1,42,5,11,0.455,3,8,0.375,2,3,0.667,2,2,1,2,4,6,3,6,1,1,6,15
2020,Phoenix Mercury,Playoffs,6,Shatori Walker-Kimbrough,25,2,1,38,5,10,0.5,4,6,0.667,1,4,0.25,3,6,0.5,1,2,3,3,0,1,2,2,17
2020,Phoenix Mercury,Playoffs,7,Sophie Cunningham,23,2,0,19,2,4,0.5,1,3,0.333,1,1,1,0,0,,0,2,2,0,0,0,3,2,5
2020,Phoenix Mercury,Playoffs,8,Alanna Smith,23,2,0,16,1,4,0.25,1,2,0.5,0,2,0,2,2,1,0,2,2,0,1,1,2,3,5
2020,Indiana Fever,Regular Season,1,Julie Allemand,23,22,22,716,61,134,0.455,44,92,0.478,17,42,0.405,22,30,0.733,8,92,100,128,25,9,57,57,188
2020,Indiana Fever,Regular Season,2,Kelsey Mitchell,24,22,22,706,138,308,0.448,56,144,0.389,82,164,0.5,62,73,0.849,6,42,48,62,14,2,54,62,394
2020,Indiana Fever,Regular Season,3,Candice Dupree,35,22,22,665,116,251,0.462,3,18,0.167,113,233,0.485,41,48,0.854,27,98,125,55,16,9,28,27,276
2020,Indiana Fever,Regular Season,4,Tiffany Mitchell,25,19,11,502,74,214,0.346,17,73,0.233,57,141,0.404,77,81,0.951,15,50,65,49,12,2,45,49,242
2020,Indiana Fever,Regular Season,5,Teaira McCowan,23,22,10,461,90,168,0.536,0,3,0,90,165,0.545,60,80,0.75,69,92,161,14,7,22,44,58,240
2020,Indiana Fever,Regular Season,6,Kennedy Burke,23,22,11,403,57,127,0.449,15,48,0.313,42,79,0.532,30,42,0.714,19,20,39,25,14,8,27,24,159
2020,Indiana Fever,Regular Season,7,Natalie Achonwa,27,18,11,364,57,115,0.496,0,10,0,57,105,0.543,26,32,0.813,26,73,99,31,9,11,33,46,140
2020,Indiana Fever,Regular Season,8,Lauren Cox,22,14,1,183,18,43,0.419,3,6,0.5,15,37,0.405,11,15,0.733,10,36,46,19,6,4,11,20,50
2020,Indiana Fever,Regular Season,9,Kathleen Doyle,22,18,0,155,10,41,0.244,5,21,0.238,5,20,0.25,2,4,0.5,3,12,15,19,7,0,18,26,27
2020,Indiana Fever,Regular Season,10,Kamiah Smalls,22,7,0,100,9,20,0.45,7,12,0.583,2,8,0.25,2,2,1,5,3,8,14,1,1,2,3,27
2020,Indiana Fever,Regular Season,11,Victoria Vivians,25,6,0,85,10,29,0.345,2,11,0.182,8,18,0.444,7,8,0.875,2,12,14,3,1,0,6,15,29
2020,Indiana Fever,Regular Season,12,Stephanie Mavunga,25,5,0,59,8,18,0.444,0,2,0,8,16,0.5,9,11,0.818,7,13,20,3,0,2,5,3,25
2020,Indiana Fever,Regular Season,13,Alisia Jenkins,26,1,0,2,0,0,,0,0,,0,0,,0,0,,0,1,1,0,0,0,0,0,0
2020,Connecticut Sun,Regular Season,1,DeWanna Bonner,32,22,22,732,148,351,0.422,27,107,0.252,121,244,0.496,111,124,0.895,34,138,172,65,37,12,52,47,434
2020,Connecticut Sun,Regular Season,2,Alyssa Thomas,28,21,21,689,122,244,0.5,0,1,0,122,243,0.502,81,118,0.686,39,151,190,101,42,6,52,59,325
2020,Connecticut Sun,Regular Season,3,Brionna Jones,24,21,21,549,98,162,0.605,1,1,1,97,161,0.602,38,55,0.691,59,59,118,21,35,14,34,65,235
2020,Connecticut Sun,Regular Season,4,Jasmine Thomas,30,19,19,485,76,188,0.404,21,63,0.333,55,125,0.44,21,23,0.913,4,29,33,76,24,5,46,30,194
2020,Connecticut Sun,Regular Season,5,Natisha Hiedeman,23,22,4,408,45,127,0.354,23,64,0.359,22,63,0.349,21,30,0.7,8,34,42,41,8,0,24,43,134
2020,Connecticut Sun,Regular Season,6,Kaila Charles,22,21,7,376,40,97,0.412,11,30,0.367,29,67,0.433,22,31,0.71,23,31,54,19,16,7,19,45,113
2020,Connecticut Sun,Regular Season,7,Briann January,33,13,10,303,22,75,0.293,11,31,0.355,11,44,0.25,10,12,0.833,4,12,16,44,8,2,15,25,65
2020,Connecticut Sun,Regular Season,8,Bria Holmes,26,18,4,291,35,98,0.357,10,30,0.333,25,68,0.368,8,12,0.667,13,20,33,20,13,5,18,17,88
2020,Connecticut Sun,Regular Season,9,Beatrice Mompremier,23,21,0,187,20,47,0.426,0,0,,20,47,0.426,8,18,0.444,32,38,70,3,5,13,14,28,48
2020,Connecticut Sun,Regular Season,10,Kaleena Mosqueda-Lewis,26,16,0,164,19,64,0.297,12,47,0.255,7,17,0.412,4,7,0.571,1,20,21,4,3,1,7,17,54
2020,Connecticut Sun,Regular Season,11,Essence Carson,33,11,2,123,13,40,0.325,6,21,0.286,7,19,0.368,3,4,0.75,1,16,17,7,4,1,6,12,35
2020,Connecticut Sun,Regular Season,12,Theresa Plaisance,28,13,0,90,11,29,0.379,5,17,0.294,6,12,0.5,5,6,0.833,2,11,13,1,5,3,2,20,32
2020,Connecticut Sun,Regular Season,13,Jacki Gemelos,31,6,0,29,4,8,0.5,3,6,0.5,1,2,0.5,0,0,,0,2,2,1,2,0,3,5,11
2020,Connecticut Sun,Playoffs,1,DeWanna Bonner,32,7,7,245,33,99,0.333,10,35,0.286,23,64,0.359,32,32,1,8,65,73,27,13,8,16,18,108
2020,Connecticut Sun,Playoffs,2,Briann January,33,7,7,228,25,72,0.347,10,29,0.345,15,43,0.349,3,3,1,2,11,13,25,6,0,6,15,63
2020,Connecticut Sun,Playoffs,3,Alyssa Thomas,28,7,7,227,51,99,0.515,0,0,,51,99,0.515,23,30,0.767,21,36,57,28,12,3,15,22,125
2020,Connecticut Sun,Playoffs,4,Jasmine Thomas,30,7,7,224,41,91,0.451,13,40,0.325,28,51,0.549,8,10,0.8,1,14,15,31,8,1,13,12,103
2020,Connecticut Sun,Playoffs,5,Brionna Jones,24,7,7,198,29,64,0.453,0,0,,29,64,0.453,8,9,0.889,25,26,51,10,11,2,10,22,66
2020,Connecticut Sun,Playoffs,6,Beatrice Mompremier,23,7,0,86,5,15,0.333,0,0,,5,15,0.333,2,5,0.4,6,19,25,1,4,6,3,17,12
2020,Connecticut Sun,Playoffs,7,Kaila Charles,22,7,0,82,9,24,0.375,2,11,0.182,7,13,0.538,8,8,1,5,7,12,3,1,1,9,7,28
2020,Connecticut Sun,Playoffs,8,Natisha Hiedeman,23,7,0,54,7,13,0.538,5,8,0.625,2,5,0.4,5,6,0.833,0,5,5,9,2,1,4,4,24
2020,Connecticut Sun,Playoffs,9,Essence Carson,33,5,0,39,6,13,0.462,1,5,0.2,5,8,0.625,0,0,,0,2,2,0,1,2,2,2,13
2020,Connecticut Sun,Playoffs,10,Theresa Plaisance,28,3,0,12,0,2,0,0,1,0,0,1,0,0,0,,0,2,2,1,0,1,2,2,0
2020,Connecticut Sun,Playoffs,11,Kaleena Mosqueda-Lewis,26,2,0,5,1,2,0.5,0,1,0,1,1,1,0,0,,0,0,0,1,0,0,0,0,2
2020,Dallas Wings,Regular Season,1,Arike Ogunbowale,23,22,22,748,173,419,0.413,48,143,0.336,125,276,0.453,107,125,0.856,10,51,61,76,35,0,47,54,501
2020,Dallas Wings,Regular Season,2,Kayla Thornton,27,22,14,557,54,126,0.429,25,72,0.347,29,54,0.537,28,32,0.875,32,81,113,17,19,4,25,65,161
2020,Dallas Wings,Regular Season,3,Allisha Gray,25,20,14,524,91,196,0.464,25,71,0.352,66,125,0.528,54,65,0.831,27,57,84,26,22,6,22,38,261
2020,Dallas Wings,Regular Season,4,Satou Sabally,22,16,14,450,67,182,0.368,13,66,0.197,54,116,0.466,75,86,0.872,41,83,124,40,14,14,35,50,222
2020,Dallas Wings,Regular Season,5,Katie Lou Samuelson,23,22,4,439,40,96,0.417,19,60,0.317,21,36,0.583,11,15,0.733,8,45,53,30,15,9,12,32,110
2020,Dallas Wings,Regular Season,6,Tyasha Harris,22,21,3,412,55,127,0.433,19,56,0.339,36,71,0.507,14,22,0.636,0,26,26,56,18,3,18,36,143
2020,Dallas Wings,Regular Season,7,Marina Mabrey,23,19,12,405,68,158,0.43,38,91,0.418,30,67,0.448,16,24,0.667,11,48,59,43,25,2,30,36,190
2020,Dallas Wings,Regular Season,8,Bella Alarie,22,22,3,309,24,66,0.364,1,13,0.077,23,53,0.434,10,12,0.833,23,40,63,11,14,18,11,35,59
2020,Dallas Wings,Regular Season,9,Isabelle Harrison,26,13,11,258,34,76,0.447,0,3,0,34,73,0.466,15,19,0.789,19,41,60,19,9,5,18,32,83
2020,Dallas Wings,Regular Season,10,Astou Ndour-Fall,25,13,7,151,20,57,0.351,6,25,0.24,14,32,0.438,0,0,,13,25,38,6,3,6,6,29,46
2020,Dallas Wings,Regular Season,11,Moriah Jefferson,26,9,6,148,18,44,0.409,2,6,0.333,16,38,0.421,7,12,0.583,8,20,28,18,7,2,15,17,45
2020,Dallas Wings,Regular Season,12,Megan Gustafson,23,10,0,48,4,14,0.286,0,1,0,4,13,0.308,6,9,0.667,6,5,11,1,0,1,2,9,14
2020,Washington Mystics,Regular Season,1,Ariel Atkins,23,22,22,682,110,251,0.438,44,107,0.411,66,144,0.458,62,70,0.886,18,46,64,53,40,4,42,58,326
2020,Washington Mystics,Regular Season,2,Leilani Mitchell,35,22,22,673,73,179,0.408,29,95,0.305,44,84,0.524,34,39,0.872,11,51,62,119,18,1,38,46,209
2020,Washington Mystics,Regular Season,3,Myisha Hines-Allen,24,22,22,659,150,294,0.51,26,61,0.426,124,233,0.532,48,58,0.828,35,160,195,57,31,5,48,63,374
2020,Washington Mystics,Regular Season,4,Emma Meesseman,27,20,20,634,109,240,0.454,13,45,0.289,96,195,0.492,29,35,0.829,33,73,106,90,24,16,40,35,260
2020,Washington Mystics,Regular Season,5,Kiara Leslie,24,19,10,414,38,108,0.352,17,47,0.362,21,61,0.344,12,13,0.923,15,42,57,20,9,7,18,27,105
2020,Washington Mystics,Regular Season,6,Tianna Hawkins,29,17,5,329,53,130,0.408,17,57,0.298,36,73,0.493,22,26,0.846,12,48,60,17,14,6,20,44,145
2020,Washington Mystics,Regular Season,7,Alaina Coates,25,20,0,197,18,34,0.529,0,0,,18,34,0.529,14,26,0.538,20,35,55,9,7,4,12,33,50
2020,Washington Mystics,Regular Season,8,Jacki Gemelos,31,12,1,193,15,48,0.313,6,29,0.207,9,19,0.474,2,4,0.5,3,14,17,14,4,1,9,13,38
2020,Washington Mystics,Regular Season,9,Aerial Powers,26,6,6,179,32,69,0.464,9,26,0.346,23,43,0.535,25,30,0.833,2,27,29,15,9,0,11,16,98
2020,Washington Mystics,Regular Season,10,Essence Carson,33,10,0,168,17,59,0.288,6,23,0.261,11,36,0.306,3,6,0.5,6,12,18,5,5,1,10,9,43
2020,Washington Mystics,Regular Season,11,Shey Peddy,31,9,0,116,9,29,0.31,2,15,0.133,7,14,0.5,12,12,1,2,9,11,11,7,0,8,8,32
2020,Washington Mystics,Regular Season,12,Sug Sutton,21,12,0,113,12,33,0.364,5,17,0.294,7,16,0.438,5,7,0.714,0,8,8,12,1,0,6,11,34
2020,Washington Mystics,Regular Season,13,Stella Johnson,21,5,2,94,16,33,0.485,9,14,0.643,7,19,0.368,5,5,1,4,6,10,12,5,2,4,10,46
2020,Washington Mystics,Playoffs,1,Ariel Atkins,23,1,1,36,6,16,0.375,0,3,0,6,13,0.462,1,1,1,2,2,4,4,2,0,0,1,13
2020,Washington Mystics,Playoffs,2,Leilani Mitchell,35,1,1,36,8,15,0.533,5,7,0.714,3,8,0.375,4,5,0.8,0,2,2,4,0,0,3,2,25
2020,Washington Mystics,Playoffs,3,Emma Meesseman,27,1,1,35,8,15,0.533,2,2,1,6,13,0.462,0,0,,2,1,3,4,2,1,0,1,18
2020,Washington Mystics,Playoffs,4,Kiara Leslie,24,1,1,33,3,9,0.333,0,3,0,3,6,0.5,1,1,1,1,5,6,4,1,2,1,4,7
2020,Washington Mystics,Playoffs,5,Myisha Hines-Allen,24,1,1,27,4,6,0.667,1,1,1,3,5,0.6,2,2,1,0,9,9,1,0,2,3,4,11
2020,Washington Mystics,Playoffs,6,Tianna Hawkins,29,1,0,15,1,7,0.143,0,1,0,1,6,0.167,3,4,0.75,2,3,5,0,0,0,2,4,5
2020,Washington Mystics,Playoffs,7,Jacki Gemelos,31,1,0,11,1,3,0.333,1,1,1,0,2,0,0,0,,1,2,3,2,0,0,0,0,3
2020,Washington Mystics,Playoffs,8,Alaina Coates,25,1,0,4,0,1,0,0,0,,0,1,0,0,0,,1,0,1,0,0,0,0,1,0
2020,Washington Mystics,Playoffs,9,Sug Sutton,21,1,0,4,1,2,0.5,0,0,,1,2,0.5,0,0,,0,1,1,0,0,0,0,0,2
2020,Atlanta Dream,Regular Season,1,Betnijah Laney,26,22,22,738,143,297,0.481,30,74,0.405,113,223,0.507,62,75,0.827,24,83,107,87,35,2,66,56,378
2020,Atlanta Dream,Regular Season,2,Elizabeth Williams,27,22,22,647,87,178,0.489,0,0,,87,178,0.489,49,66,0.742,49,76,125,31,17,30,25,57,223
2020,Atlanta Dream,Regular Season,3,Courtney Williams,26,20,14,615,134,307,0.436,8,34,0.235,126,273,0.462,16,23,0.696,37,106,143,63,13,2,54,39,292
2020,Atlanta Dream,Regular Season,4,Monique Billings,24,22,16,596,68,170,0.4,0,0,,68,170,0.4,51,67,0.761,58,129,187,27,24,18,42,62,187
2020,Atlanta Dream,Regular Season,5,Shekinna Stricklen,29,22,15,482,47,138,0.341,33,99,0.333,14,39,0.359,8,8,1,4,38,42,14,7,1,15,43,135
2020,Atlanta Dream,Regular Season,6,Blake Dietrick,26,22,4,463,49,104,0.471,26,58,0.448,23,46,0.5,5,8,0.625,8,28,36,75,18,3,40,42,129
2020,Atlanta Dream,Regular Season,7,Chennedy Carter,21,16,16,406,106,224,0.473,12,32,0.375,94,192,0.49,55,67,0.821,8,28,36,55,14,5,43,57,279
2020,Atlanta Dream,Regular Season,8,Glory Johnson,29,18,1,277,31,83,0.373,11,42,0.262,20,41,0.488,12,24,0.5,7,60,67,11,15,7,13,27,85
2020,Atlanta Dream,Regular Season,9,Jaylyn Agnew,22,12,0,71,4,15,0.267,3,13,0.231,1,2,0.5,4,5,0.8,0,5,5,3,0,0,5,7,15
2020,Atlanta Dream,Regular Season,10,Kalani Brown,23,10,0,61,12,23,0.522,0,0,,12,23,0.522,6,10,0.6,3,9,12,0,1,1,5,10,30
2020,Atlanta Dream,Regular Season,11,Alexis Jones,26,6,0,53,8,21,0.381,7,19,0.368,1,2,0.5,1,2,0.5,0,0,0,5,3,0,6,3,24
2020,Atlanta Dream,Regular Season,12,Brittany Brewer,22,5,0,33,2,3,0.667,0,0,,2,3,0.667,0,0,,1,4,5,0,3,4,2,4,4
2020,Atlanta Dream,Regular Season,13,Erica McCall,24,1,0,5,0,0,,0,0,,0,0,,0,0,,0,2,2,0,1,0,0,1,0
2020,Atlanta Dream,Regular Season,14,Kaela Davis,25,2,0,2,0,0,,0,0,,0,0,,0,0,,0,0,0,0,0,0,0,0,0
2020,New York Liberty,Regular Season,1,Kiah Stokes,27,22,22,601,51,137,0.372,20,85,0.235,31,52,0.596,4,7,0.571,28,119,147,26,11,26,29,45,126
2020,New York Liberty,Regular Season,2,Kia Nurse,24,21,18,578,68,249,0.273,31,130,0.238,37,119,0.311,89,103,0.864,11,49,60,48,11,4,46,38,256
2020,New York Liberty,Regular Season,3,Amanda Zahui B.,26,21,20,531,65,184,0.353,34,100,0.34,31,84,0.369,25,36,0.694,15,163,178,40,19,26,54,65,189
2020,New York Liberty,Regular Season,4,Layshia Clarendon,29,19,19,496,74,159,0.465,15,44,0.341,59,115,0.513,55,63,0.873,6,42,48,74,18,0,64,55,218
2020,New York Liberty,Regular Season,5,Leaonna Odom,22,22,16,453,48,98,0.49,5,20,0.25,43,78,0.551,20,23,0.87,34,16,50,16,15,8,15,37,121
2020,New York Liberty,Regular Season,6,Jazmine Jones,23,20,2,428,69,171,0.404,15,45,0.333,54,126,0.429,63,80,0.788,18,63,81,45,28,9,57,59,216
2020,New York Liberty,Regular Season,7,Jocelyn Willoughby,22,22,5,383,39,109,0.358,15,37,0.405,24,72,0.333,35,42,0.833,15,38,53,20,15,6,32,50,128
2020,New York Liberty,Regular Season,8,Kylee Shook,22,20,0,290,32,79,0.405,3,17,0.176,29,62,0.468,14,17,0.824,15,41,56,11,7,10,20,26,81
2020,New York Liberty,Regular Season,9,Megan Walker,21,18,0,205,25,78,0.321,6,43,0.14,19,35,0.543,3,5,0.6,11,16,27,6,4,0,7,15,59
2020,New York Liberty,Regular Season,10,Joyner Holmes,22,19,0,190,22,72,0.306,3,28,0.107,19,44,0.432,9,12,0.75,15,36,51,13,2,2,13,14,56
2020,New York Liberty,Regular Season,11,Paris Kea,24,11,5,165,28,73,0.384,13,33,0.394,15,40,0.375,7,8,0.875,5,17,22,16,7,3,19,12,76
2020,New York Liberty,Regular Season,12,Sabrina Ionescu,22,3,3,80,19,42,0.452,7,20,0.35,12,22,0.545,10,10,1,2,12,14,12,2,0,13,4,55